코드그룹,년도,지역,구분,국비,사비,합계
0.0,2023,서울,수술,1,1,2
1.1,2023,서울,수술,0,1,1
1.2,2020,부산,수술,4,0,4
1.3,2023,서울,수술,22,32,54
1.5,2023,서울,수술,2,2,4
10.,2023,서울,수술,2,2,4
11.,2023,서울,수술,4,4,8
12.,2020,부산,수술,1,0,1
12.,2023,서울,수술,76,75,151
13.,2020,부산,수술,374,116,490
13.,2023,서울,수술,1452,905,2357
14.,2020,부산,수술,16,0,16
14.,2023,서울,수술,369,382,751
15.,2023,서울,수술,3,0,3
16.,2023,서울,수술,7,2,9
18.,2023,서울,수술,7,17,24
19.,2023,서울,수술,20,34,54
2.3,2023,서울,수술,2,4,6
20.,2023,서울,수술,50,39,89
21.,2020,부산,수술,21,4,25
21.,2023,서울,수술,77,59,136
22.,2020,부산,수술,7,2,9
22.,2023,서울,수술,143,131,274
24.,2023,서울,수술,1,0,1
25.,2023,서울,수술,10,3,13
26.,2023,서울,수술,8,6,14
27.,2023,서울,수술,14,8,22
28,2023,서울,수술,2,0,2
28.,2023,서울,수술,6,5,11
29.,2023,서울,수술,10,8,18
3.0,2020,부산,수술,2,1,3
3.0,2023,서울,수술,124,134,258
3.1,2020,부산,수술,19,0,19
3.3,2023,서울,수술,0,2,2
3.4,2023,서울,수술,1,0,1
3.5,2020,부산,수술,145,9,154
3.5,2023,서울,수술,23,70,93
3.6,2020,부산,수술,6,0,6
3.6,2023,서울,수술,2,0,2
3.9,2020,부산,수술,170,7,177
3.9,2023,서울,수술,258,198,456
30.,2023,서울,수술,41,24,65
31.,2020,부산,수술,1,0,1
31.,2023,서울,수술,69,37,106
32.,2023,서울,수술,57,31,88
33.,2023,서울,수술,3,1,4
34.,2023,서울,수술,38,21,59
35.,2023,서울,수술,30,10,40
36.,2023,서울,수술,41,18,59
37.,2023,서울,수술,10,2,12
38.,2020,부산,수술,10,2,12
38.,2023,서울,수술,173,123,296
39.,2020,부산,수술,11,0,11
39.,2023,서울,수술,235,144,379
4.0,2020,부산,수술,1,0,1
4.4,2020,부산,수술,6,3,9
4.4,2023,서울,수술,18,11,29
4.6,2023,서울,수술,3,8,11
4.7,2020,부산,수술,524,3,527
4.7,2023,서울,수술,68,7,75
4.8,2023,서울,수술,91,204,295
40.,2023,서울,수술,170,150,320
41.,2023,서울,수술,5,4,9
43.,2020,부산,수술,5,0,5
43.,2023,서울,수술,44,39,83
44.,2023,서울,수술,10,2,12
45.,2020,부산,수술,4,0,4
45.,2023,서울,수술,67,72,139
46.,2023,서울,수술,33,23,56
47.,2020,부산,수술,6,5,11
47.,2023,서울,수술,24,35,59
48.,2020,부산,수술,1,0,1
48.,2023,서울,수술,19,27,46
49.,2020,부산,수술,3,6,9
49.,2023,서울,수술,50,92,142
5.3,2023,서울,수술,1,1,2
50,2023,서울,수술,0,3,3
50.,2023,서울,수술,8,9,17
51.,2020,부산,수술,25,24,49
51.,2023,서울,수술,93,122,215
52.,2023,서울,수술,7,2,9
53.,2020,부산,수술,25,23,48
53.,2023,서울,수술,132,120,252
54,2023,서울,수술,1,1,2
54.,2020,부산,수술,1,0,1
54.,2023,서울,수술,415,394,809
55,2023,서울,수술,8,2,10
55.,2023,서울,수술,16,17,33
56,2023,서울,수술,15,19,34
56.,2023,서울,수술,36,19,55
57,2023,서울,수술,12,25,37
57.,2020,부산,수술,48,3,51
57.,2023,서울,수술,243,116,359
58.,2020,부산,수술,11,0,11
58.,2023,서울,수술,53,13,66
59.,2023,서울,수술,46,65,111
6.2,2020,부산,수술,0,1,1
6.2,2023,서울,수술,19,11,30
6.3,2023,서울,수술,1,0,1
6.4,2023,서울,수술,1,1,2
6.8,2023,서울,수술,3,0,3
60.,2020,부산,수술,135,70,205
60.,2023,서울,수술,184,160,344
61,2023,서울,수술,2,0,2
61.,2023,서울,수술,3,1,4
62.,2020,부산,수술,1,0,1
62.,2023,서울,수술,1,1,2
63.,2020,부산,수술,4,2,6
63.,2023,서울,수술,10,13,23
64,2023,서울,수술,3,2,5
64.,2020,부산,수술,14,0,14
64.,2023,서울,수술,18,5,23
65.,2023,서울,수술,0,49,49
66.,2023,서울,수술,0,5,5
67.,2023,서울,수술,0,10,10
68.,2023,서울,수술,1,169,170
69.,2023,서울,수술,0,1,1
7.2,2023,서울,수술,3,1,4
7.6,2023,서울,수술,2,4,6
70.,2023,서울,수술,1,24,25
71.,2023,서울,수술,0,6,6
76.,2023,서울,수술,1,0,1
77.,2020,부산,수술,7,0,7
77.,2023,서울,수술,34,41,75
78.,2020,부산,수술,15,15,30
78.,2023,서울,수술,71,78,149
79.,2020,부산,수술,15,15,30
79.,2023,서울,수술,58,116,174
8.2,2023,서울,수술,2,1,3
8.3,2023,서울,수술,4,0,4
8.4,2023,서울,수술,7,8,15
8.8,2023,서울,수술,2,2,4
8.9,2023,서울,수술,2,1,3
80.,2020,부산,수술,87,93,180
80.,2023,서울,수술,226,276,502
81.,2020,부산,수술,99,66,165
81.,2023,서울,수술,344,690,1034
82.,2020,부산,수술,6,1,7
82.,2023,서울,수술,0,4,4
83.,2020,부산,수술,133,19,152
83.,2023,서울,수술,140,196,336
84.,2020,부산,수술,5,1,6
84.,2023,서울,수술,97,83,180
85.,2023,서울,수술,4,40,44
86.,2020,부산,수술,24,5,29
86.,2023,서울,수술,200,93,293
87.,2023,서울,수술,6,8,14
88.,2020,부산,수술,1,0,1
88.,2023,서울,수술,0,2,2
9.4,2023,서울,수술,4,3,7
9.7,2023,서울,수술,0,1,1
9.8,2023,서울,수술,2,2,4
92.,2023,서울,수술,1,0,1
93.,2020,부산,수술,12,1,13
93.,2023,서울,수술,12,11,23
96.,2023,서울,수술,46,15,61
97.,2020,부산,수술,1,0,1
97.,2023,서울,수술,15,14,29
98.,2020,부산,수술,1,3,4
99.,2020,부산,수술,1,0,1
99.,2023,서울,수술,3,12,15
A01,2023,대구,질병,0,1,1
A01,2023,부산,질병,0,2,2
A02,2019,광주,질병,1,2,3
A02,2019,대구,질병,1,0,1
A02,2019,서울,질병,1,1,2
A02,2020,광주,질병,0,1,1
A02,2020,서울,질병,0,3,3
A02,2021,광주,질병,0,1,1
A02,2021,대전,질병,1,0,1
A02,2021,서울,질병,2,0,2
A02,2022,대구,질병,1,1,2
A02,2023,광주,질병,4,1,5
A02,2023,대구,질병,0,1,1
A02,2023,서울,질병,0,1,1
A03,2020,광주,질병,0,1,1
A04,2019,광주,질병,4,9,13
A04,2019,대구,질병,6,5,11
A04,2019,대전,질병,7,5,12
A04,2019,부산,질병,4,0,4
A04,2019,서울,질병,96,72,168
A04,2019,인천,질병,0,1,1
A04,2020,광주,질병,2,6,8
A04,2020,대구,질병,3,5,8
A04,2020,대전,질병,7,10,17
A04,2020,서울,질병,160,98,258
A04,2021,광주,질병,4,2,6
A04,2021,대구,질병,5,3,8
A04,2021,대전,질병,7,3,10
A04,2021,부산,질병,2,0,2
A04,2021,서울,질병,73,59,132
A04,2022,광주,질병,1,3,4
A04,2022,대구,질병,2,0,2
A04,2022,대전,질병,3,10,13
A04,2022,부산,질병,0,1,1
A04,2022,서울,질병,100,79,179
A04,2023,광주,질병,8,6,14
A04,2023,대구,질병,2,5,7
A04,2023,대전,질병,9,12,21
A04,2023,서울,질병,138,97,235
A05,2022,대전,질병,0,1,1
A05,2023,대전,질병,1,0,1
A08,2019,광주,질병,0,20,20
A08,2019,대구,질병,1,0,1
A08,2019,대전,질병,4,3,7
A08,2020,광주,질병,1,6,7
A08,2020,대전,질병,5,0,5
A08,2020,서울,질병,2,0,2
A08,2021,대구,질병,1,1,2
A08,2021,대전,질병,2,4,6
A08,2022,광주,질병,2,0,2
A08,2022,대구,질병,6,0,6
A08,2022,대전,질병,2,10,12
A08,2022,서울,질병,0,1,1
A08,2023,대구,질병,2,0,2
A08,2023,대전,질병,2,2,4
A08,2023,서울,질병,1,1,2
A09,2019,광주,질병,25,94,119
A09,2019,대구,질병,71,52,123
A09,2019,대전,질병,29,48,77
A09,2019,부산,질병,31,16,47
A09,2019,서울,질병,109,97,206
A09,2019,인천,질병,12,22,34
A09,2020,광주,질병,29,77,106
A09,2020,대구,질병,45,31,76
A09,2020,대전,질병,37,49,86
A09,2020,서울,질병,105,92,197
A09,2020,인천,질병,11,13,24
A09,2021,광주,질병,37,47,84
A09,2021,대구,질병,54,21,75
A09,2021,대전,질병,30,43,73
A09,2021,부산,질병,30,17,47
A09,2021,서울,질병,59,61,120
A09,2021,인천,질병,7,11,18
A09,2022,광주,질병,27,22,49
A09,2022,대구,질병,45,32,77
A09,2022,대전,질병,32,25,57
A09,2022,부산,질병,18,13,31
A09,2022,서울,질병,76,78,154
A09,2022,인천,질병,3,5,8
A09,2023,광주,질병,39,39,78
A09,2023,대구,질병,43,27,70
A09,2023,대전,질병,22,27,49
A09,2023,부산,질병,24,6,30
A09,2023,서울,질병,101,78,179
A09,2023,인천,질병,3,13,16
A15,2019,광주,질병,8,8,16
A15,2019,대구,질병,6,3,9
A15,2019,대전,질병,3,5,8
A15,2019,부산,질병,2,4,6
A15,2019,서울,질병,36,30,66
A15,2019,인천,질병,0,1,1
A15,2020,광주,질병,1,11,12
A15,2020,대구,질병,2,0,2
A15,2020,대전,질병,2,6,8
A15,2020,서울,질병,30,27,57
A15,2020,인천,질병,0,1,1
A15,2021,광주,질병,7,2,9
A15,2021,대구,질병,1,2,3
A15,2021,대전,질병,0,1,1
A15,2021,부산,질병,5,3,8
A15,2021,서울,질병,14,15,29
A15,2021,인천,질병,0,1,1
A15,2022,광주,질병,3,0,3
A15,2022,대구,질병,2,2,4
A15,2022,대전,질병,0,2,2
A15,2022,부산,질병,2,1,3
A15,2022,서울,질병,16,12,28
A15,2023,대구,질병,5,4,9
A15,2023,대전,질병,0,2,2
A15,2023,부산,질병,6,6,12
A15,2023,서울,질병,18,15,33
A15,2023,인천,질병,1,2,3
A16,2019,광주,질병,6,10,16
A16,2019,대구,질병,6,5,11
A16,2019,대전,질병,2,8,10
A16,2019,부산,질병,2,1,3
A16,2019,서울,질병,5,8,13
A16,2020,광주,질병,4,10,14
A16,2020,대구,질병,2,2,4
A16,2020,대전,질병,3,2,5
A16,2020,서울,질병,4,7,11
A16,2021,광주,질병,3,8,11
A16,2021,대구,질병,4,0,4
A16,2021,대전,질병,1,1,2
A16,2021,부산,질병,1,3,4
A16,2021,서울,질병,3,4,7
A16,2022,광주,질병,0,4,4
A16,2022,대구,질병,4,0,4
A16,2022,대전,질병,0,3,3
A16,2022,부산,질병,1,0,1
A16,2022,서울,질병,7,4,11
A16,2023,광주,질병,5,1,6
A16,2023,대구,질병,2,1,3
A16,2023,대전,질병,3,1,4
A16,2023,부산,질병,1,0,1
A16,2023,서울,질병,7,7,14
A17,2019,서울,질병,0,1,1
A17,2020,광주,질병,0,1,1
A17,2020,서울,질병,2,1,3
A17,2023,광주,질병,0,1,1
A18,2019,광주,질병,1,0,1
A18,2019,대구,질병,1,1,2
A18,2019,부산,질병,3,0,3
A18,2019,서울,질병,7,10,17
A18,2020,광주,질병,2,0,2
A18,2020,대구,질병,3,2,5
A18,2020,서울,질병,5,6,11
A18,2021,광주,질병,0,1,1
A18,2021,서울,질병,0,3,3
A18,2022,서울,질병,2,0,2
A18,2023,서울,질병,2,8,10
A19,2019,광주,질병,0,2,2
A19,2019,대구,질병,0,1,1
A19,2019,서울,질병,2,2,4
A19,2020,광주,질병,0,1,1
A19,2020,서울,질병,0,1,1
A19,2021,광주,질병,1,0,1
A19,2021,대구,질병,0,2,2
A19,2022,서울,질병,1,0,1
A19,2023,서울,질병,1,3,4
A20,2019,서울,질병,1,0,1
A26,2019,광주,질병,1,0,1
A27,2019,서울,질병,1,0,1
A27,2021,대전,질병,1,0,1
A31,2019,광주,질병,7,2,9
A31,2019,대구,질병,2,1,3
A31,2019,대전,질병,2,1,3
A31,2019,부산,질병,0,2,2
A31,2019,서울,질병,13,11,24
A31,2020,광주,질병,2,1,3
A31,2020,대전,질병,0,3,3
A31,2020,서울,질병,9,20,29
A31,2021,광주,질병,2,2,4
A31,2021,부산,질병,1,0,1
A31,2021,서울,질병,11,15,26
A31,2022,광주,질병,3,1,4
A31,2022,부산,질병,0,1,1
A31,2022,서울,질병,12,14,26
A31,2022,인천,질병,1,0,1
A31,2023,대전,질병,0,1,1
A31,2023,부산,질병,1,0,1
A31,2023,서울,질병,14,18,32
A32,2020,서울,질병,0,1,1
A32,2022,서울,질병,1,0,1
A36,2020,서울,질병,0,1,1
A37,2019,광주,질병,1,0,1
A37,2019,대구,질병,0,1,1
A39,2019,서울,질병,0,1,1
A39,2022,서울,질병,1,0,1
A40,2019,서울,질병,4,2,6
A40,2020,서울,질병,0,1,1
A40,2021,대구,질병,0,1,1
A40,2021,서울,질병,3,4,7
A40,2022,서울,질병,7,5,12
A40,2023,서울,질병,5,7,12
A41,2019,광주,질병,8,19,27
A41,2019,대구,질병,12,16,28
A41,2019,대전,질병,9,4,13
A41,2019,부산,질병,6,1,7
A41,2019,서울,질병,106,103,209
A41,2019,인천,질병,1,1,2
A41,2020,광주,질병,16,6,22
A41,2020,대구,질병,12,5,17
A41,2020,대전,질병,9,7,16
A41,2020,서울,질병,143,108,251
A41,2020,인천,질병,2,1,3
A41,2021,광주,질병,9,11,20
A41,2021,대구,질병,12,6,18
A41,2021,대전,질병,4,8,12
A41,2021,부산,질병,7,1,8
A41,2021,서울,질병,81,79,160
A41,2022,광주,질병,5,7,12
A41,2022,대구,질병,14,4,18
A41,2022,대전,질병,3,2,5
A41,2022,부산,질병,3,1,4
A41,2022,서울,질병,117,82,199
A41,2023,광주,질병,5,13,18
A41,2023,대구,질병,13,10,23
A41,2023,대전,질병,6,0,6
A41,2023,부산,질병,6,1,7
A41,2023,서울,질병,126,105,231
A42,2019,서울,질병,2,3,5
A42,2020,광주,질병,0,1,1
A42,2020,서울,질병,1,2,3
A42,2021,대전,질병,1,0,1
A42,2021,서울,질병,3,0,3
A42,2022,서울,질병,3,2,5
A42,2023,서울,질병,2,5,7
A46,2019,광주,질병,1,0,1
A46,2019,서울,질병,0,2,2
A46,2020,광주,질병,1,1,2
A46,2020,대구,질병,1,0,1
A46,2020,서울,질병,0,2,2
A46,2022,대구,질병,1,0,1
A46,2022,서울,질병,0,1,1
A46,2023,서울,질병,1,0,1
A48,2019,광주,질병,1,0,1
A48,2019,대구,질병,0,1,1
A48,2019,서울,질병,2,0,2
A48,2020,광주,질병,0,3,3
A48,2020,대구,질병,1,0,1
A48,2021,인천,질병,1,0,1
A48,2022,대구,질병,2,0,2
A48,2022,서울,질병,1,1,2
A49,2019,광주,질병,0,1,1
A49,2019,대구,질병,0,2,2
A49,2019,대전,질병,0,1,1
A49,2019,서울,질병,221,154,375
A49,2020,광주,질병,1,3,4
A49,2020,대구,질병,2,0,2
A49,2020,대전,질병,3,0,3
A49,2020,서울,질병,291,208,499
A49,2021,광주,질병,1,3,4
A49,2021,대구,질병,0,1,1
A49,2021,서울,질병,225,151,376
A49,2022,광주,질병,2,5,7
A49,2022,대구,질병,1,0,1
A49,2022,부산,질병,0,1,1
A49,2022,서울,질병,196,129,325
A49,2023,광주,질병,3,4,7
A49,2023,대구,질병,2,4,6
A49,2023,서울,질병,236,199,435
A51,2020,대전,질병,1,0,1
A51,2021,대전,질병,1,0,1
A51,2021,서울,질병,1,0,1
A52,2019,대전,질병,0,1,1
A52,2019,서울,질병,3,6,9
A52,2020,대전,질병,0,1,1
A52,2020,서울,질병,2,0,2
A52,2021,대구,질병,0,2,2
A52,2021,서울,질병,2,0,2
A52,2022,서울,질병,2,2,4
A52,2023,서울,질병,3,1,4
A53,2019,대전,질병,0,2,2
A53,2019,서울,질병,3,0,3
A53,2020,대전,질병,0,1,1
A53,2020,서울,질병,0,1,1
A53,2021,대전,질병,0,1,1
A53,2021,서울,질병,3,0,3
A53,2022,서울,질병,1,2,3
A53,2023,서울,질병,4,3,7
A54,2023,서울,질병,0,1,1
A56,2020,대전,질병,1,0,1
A60,2019,서울,질병,2,0,2
A60,2022,서울,질병,0,1,1
A60,2023,서울,질병,2,0,2
A63,2019,대전,질병,1,0,1
A63,2019,서울,질병,2,2,4
A63,2020,광주,질병,1,0,1
A63,2020,서울,질병,0,1,1
A63,2021,서울,질병,0,4,4
A63,2022,대구,질병,1,0,1
A63,2022,부산,질병,1,0,1
A63,2022,서울,질병,0,3,3
A63,2023,대구,질병,1,0,1
A68,2019,광주,질병,0,1,1
A68,2020,광주,질병,1,0,1
A75,2019,광주,질병,0,2,2
A75,2019,대구,질병,1,2,3
A75,2019,대전,질병,2,4,6
A75,2019,부산,질병,2,0,2
A75,2019,서울,질병,0,1,1
A75,2020,광주,질병,0,2,2
A75,2020,대구,질병,1,4,5
A75,2020,대전,질병,1,2,3
A75,2021,광주,질병,0,2,2
A75,2021,대구,질병,0,2,2
A75,2021,대전,질병,0,1,1
A75,2021,부산,질병,3,1,4
A75,2022,광주,질병,2,0,2
A75,2022,대구,질병,1,0,1
A75,2022,대전,질병,2,2,4
A75,2022,부산,질병,1,1,2
A75,2022,서울,질병,1,0,1
A75,2023,광주,질병,0,2,2
A75,2023,대구,질병,1,1,2
A75,2023,대전,질병,1,5,6
A75,2023,부산,질병,3,1,4
A75,2023,서울,질병,0,1,1
A79,2021,부산,질병,1,0,1
A81,2019,서울,질병,2,0,2
A81,2022,광주,질병,0,1,1
A81,2022,서울,질병,0,2,2
A83,2023,광주,질병,0,1,1
A86,2019,광주,질병,1,0,1
A86,2019,서울,질병,3,0,3
A86,2020,서울,질병,1,0,1
A86,2022,서울,질병,2,0,2
A87,2019,광주,질병,0,1,1
A87,2019,대구,질병,0,1,1
A87,2019,서울,질병,1,1,2
A87,2020,광주,질병,1,0,1
A87,2021,광주,질병,0,1,1
A87,2022,광주,질병,0,1,1
A87,2022,서울,질병,1,0,1
A87,2023,광주,질병,0,2,2
A87,2023,서울,질병,0,1,1
A93,2022,대구,질병,1,0,1
A93,2023,대구,질병,1,0,1
A93,2023,서울,질병,1,0,1
A98,2019,광주,질병,1,0,1
A99,2019,부산,질병,1,0,1
B00,2019,광주,질병,0,8,8
B00,2019,대구,질병,0,2,2
B00,2019,대전,질병,8,4,12
B00,2019,서울,질병,6,13,19
B00,2020,광주,질병,2,3,5
B00,2020,대전,질병,4,4,8
B00,2020,서울,질병,25,21,46
B00,2021,대구,질병,2,1,3
B00,2021,대전,질병,4,2,6
B00,2021,부산,질병,1,0,1
B00,2021,서울,질병,20,22,42
B00,2022,광주,질병,1,1,2
B00,2022,대구,질병,2,0,2
B00,2022,대전,질병,4,3,7
B00,2022,부산,질병,2,0,2
B00,2022,서울,질병,29,23,52
B00,2023,광주,질병,2,2,4
B00,2023,대구,질병,2,1,3
B00,2023,대전,질병,0,2,2
B00,2023,서울,질병,31,24,55
B01,2023,광주,질병,0,1,1
B01,2023,대구,질병,0,1,1
B02,2019,광주,질병,2,8,10
B02,2019,대구,질병,12,10,22
B02,2019,대전,질병,5,2,7
B02,2019,부산,질병,1,1,2
B02,2019,서울,질병,37,23,60
B02,2019,인천,질병,1,1,2
B02,2020,광주,질병,7,6,13
B02,2020,대구,질병,6,6,12
B02,2020,대전,질병,4,1,5
B02,2020,서울,질병,28,16,44
B02,2020,인천,질병,0,2,2
B02,2021,광주,질병,2,7,9
B02,2021,대구,질병,7,2,9
B02,2021,대전,질병,3,6,9
B02,2021,부산,질병,5,2,7
B02,2021,서울,질병,15,13,28
B02,2021,인천,질병,0,1,1
B02,2022,광주,질병,6,6,12
B02,2022,대구,질병,4,5,9
B02,2022,대전,질병,1,2,3
B02,2022,부산,질병,2,1,3
B02,2022,서울,질병,17,12,29
B02,2023,광주,질병,1,3,4
B02,2023,대구,질병,3,4,7
B02,2023,대전,질병,1,2,3
B02,2023,서울,질병,12,16,28
B02,2023,인천,질병,0,1,1
B07,2019,대전,질병,1,2,3
B07,2019,서울,질병,4,0,4
B07,2020,대구,질병,2,2,4
B07,2021,대구,질병,0,1,1
B07,2021,서울,질병,4,0,4
B07,2021,인천,질병,0,1,1
B07,2022,서울,질병,4,1,5
B07,2023,대구,질병,2,0,2
B07,2023,대전,질병,0,1,1
B07,2023,서울,질병,8,5,13
B08,2019,광주,질병,0,86,86
B08,2020,광주,질병,0,4,4
B08,2021,서울,질병,1,1,2
B08,2022,서울,질병,1,1,2
B08,2023,서울,질병,2,1,3
B09,2019,서울,질병,1,0,1
B09,2020,대구,질병,0,1,1
B09,2021,서울,질병,0,1,1
B15,2019,광주,질병,0,1,1
B15,2019,대전,질병,2,12,14
B15,2019,서울,질병,1,3,4
B15,2020,광주,질병,0,2,2
B15,2020,서울,질병,0,2,2
B15,2021,대전,질병,0,1,1
B15,2021,서울,질병,2,2,4
B15,2022,서울,질병,2,2,4
B15,2023,서울,질병,1,3,4
B16,2023,서울,질병,0,1,1
B17,2019,광주,질병,0,1,1
B17,2019,대구,질병,1,1,2
B17,2019,서울,질병,4,9,13
B17,2020,대구,질병,1,10,11
B17,2020,서울,질병,4,8,12
B17,2021,광주,질병,0,1,1
B17,2021,대전,질병,0,1,1
B17,2021,서울,질병,3,3,6
B17,2022,광주,질병,0,1,1
B17,2022,대구,질병,1,1,2
B17,2022,대전,질병,0,2,2
B17,2022,부산,질병,1,0,1
B17,2022,서울,질병,3,3,6
B17,2023,광주,질병,0,1,1
B17,2023,대전,질병,0,1,1
B17,2023,부산,질병,1,0,1
B17,2023,서울,질병,1,3,4
B18,2019,광주,질병,2,3,5
B18,2019,대구,질병,3,19,22
B18,2019,대전,질병,4,4,8
B18,2019,부산,질병,7,4,11
B18,2019,서울,질병,248,182,430
B18,2019,인천,질병,1,0,1
B18,2020,광주,질병,3,3,6
B18,2020,대구,질병,6,10,16
B18,2020,대전,질병,7,1,8
B18,2020,서울,질병,238,153,391
B18,2020,인천,질병,0,1,1
B18,2021,광주,질병,0,1,1
B18,2021,대구,질병,10,7,17
B18,2021,대전,질병,5,3,8
B18,2021,부산,질병,7,6,13
B18,2021,서울,질병,216,110,326
B18,2022,대구,질병,11,5,16
B18,2022,대전,질병,1,2,3
B18,2022,부산,질병,0,5,5
B18,2022,서울,질병,196,132,328
B18,2023,광주,질병,2,1,3
B18,2023,대구,질병,5,4,9
B18,2023,대전,질병,5,1,6
B18,2023,부산,질병,2,1,3
B18,2023,서울,질병,182,127,309
B18,2023,인천,질병,0,3,3
B19,2019,광주,질병,0,2,2
B20,2019,서울,질병,0,1,1
B20,2020,서울,질병,1,0,1
B20,2023,서울,질병,1,0,1
B22,2019,서울,질병,0,1,1
B23,2019,서울,질병,1,0,1
B24,2019,서울,질병,3,0,3
B24,2020,서울,질병,2,3,5
B24,2021,서울,질병,1,1,2
B24,2023,서울,질병,2,0,2
B25,2019,서울,질병,3,1,4
B25,2020,서울,질병,8,4,12
B25,2021,부산,질병,0,1,1
B25,2021,서울,질병,5,6,11
B25,2022,광주,질병,1,0,1
B25,2022,서울,질병,6,8,14
B25,2023,대전,질병,0,1,1
B25,2023,서울,질병,13,5,18
B26,2019,광주,질병,0,1,1
B27,2019,대구,질병,0,1,1
B27,2019,서울,질병,1,1,2
B27,2020,대구,질병,0,1,1
B27,2022,대전,질병,0,1,1
B27,2022,서울,질병,1,0,1
B27,2023,서울,질병,1,0,1
B30,2019,서울,질병,2,0,2
B30,2020,대구,질병,0,1,1
B30,2021,서울,질병,0,4,4
B30,2022,서울,질병,1,0,1
B30,2023,서울,질병,0,1,1
B33,2020,서울,질병,0,1,1
B34,2019,광주,질병,0,63,63
B34,2019,서울,질병,0,2,2
B34,2020,광주,질병,0,7,7
B34,2020,대구,질병,0,1,1
B34,2020,서울,질병,1,2,3
B34,2021,서울,질병,1,0,1
B34,2022,서울,질병,0,3,3
B34,2023,광주,질병,1,0,1
B34,2023,서울,질병,2,2,4
B35,2019,대구,질병,1,0,1
B35,2019,대전,질병,120,67,187
B35,2019,서울,질병,122,43,165
B35,2020,광주,질병,1,0,1
B35,2020,대구,질병,1,1,2
B35,2020,대전,질병,113,36,149
B35,2020,서울,질병,96,57,153
B35,2021,대구,질병,8,1,9
B35,2021,대전,질병,110,35,145
B35,2021,부산,질병,2,0,2
B35,2021,서울,질병,88,46,134
B35,2022,대구,질병,2,0,2
B35,2022,대전,질병,54,16,70
B35,2022,부산,질병,1,0,1
B35,2022,서울,질병,101,68,169
B35,2023,대전,질병,8,12,20
B35,2023,서울,질병,194,118,312
B35,2023,인천,질병,0,1,1
B36,2019,서울,질병,4,3,7
B36,2020,서울,질병,0,1,1
B36,2021,서울,질병,3,0,3
B36,2022,서울,질병,0,1,1
B36,2023,서울,질병,8,0,8
B37,2019,광주,질병,0,2,2
B37,2019,대구,질병,2,0,2
B37,2019,대전,질병,1,3,4
B37,2019,부산,질병,2,0,2
B37,2019,서울,질병,51,27,78
B37,2019,인천,질병,1,0,1
B37,2020,대구,질병,1,1,2
B37,2020,대전,질병,4,2,6
B37,2020,서울,질병,57,36,93
B37,2021,대구,질병,1,0,1
B37,2021,대전,질병,5,1,6
B37,2021,서울,질병,63,37,100
B37,2022,대구,질병,1,0,1
B37,2022,대전,질병,1,0,1
B37,2022,부산,질병,1,0,1
B37,2022,서울,질병,52,35,87
B37,2023,대구,질병,4,0,4
B37,2023,대전,질병,3,1,4
B37,2023,부산,질병,1,1,2
B37,2023,서울,질병,57,30,87
B39,2021,대구,질병,1,0,1
B40,2019,서울,질병,1,0,1
B40,2023,서울,질병,0,2,2
B44,2019,대구,질병,4,1,5
B44,2019,대전,질병,1,0,1
B44,2019,서울,질병,11,5,16
B44,2020,광주,질병,0,1,1
B44,2020,대구,질병,1,0,1
B44,2020,대전,질병,0,1,1
B44,2020,서울,질병,6,4,10
B44,2021,서울,질병,8,4,12
B44,2022,서울,질병,5,7,12
B44,2023,대전,질병,1,0,1
B44,2023,서울,질병,17,14,31
B45,2022,서울,질병,0,1,1
B46,2023,광주,질병,0,1,1
B46,2023,서울,질병,0,1,1
B48,2020,서울,질병,0,1,1
B48,2021,서울,질병,4,2,6
B48,2022,서울,질병,6,3,9
B48,2023,서울,질병,4,3,7
B49,2019,대구,질병,1,0,1
B49,2019,대전,질병,1,0,1
B49,2019,서울,질병,9,9,18
B49,2020,대전,질병,3,3,6
B49,2020,서울,질병,6,2,8
B49,2021,대구,질병,0,1,1
B49,2021,대전,질병,4,1,5
B49,2021,서울,질병,11,10,21
B49,2022,대전,질병,1,0,1
B49,2022,서울,질병,9,7,16
B49,2023,광주,질병,1,0,1
B49,2023,대전,질병,2,0,2
B49,2023,서울,질병,8,6,14
B49,2023,인천,질병,0,1,1
B54,2023,서울,질병,0,1,1
B59,2019,서울,질병,1,0,1
B59,2020,서울,질병,2,1,3
B66,2019,서울,질병,1,0,1
B66,2020,서울,질병,2,3,5
B66,2023,서울,질병,1,0,1
B69,2020,서울,질병,0,1,1
B69,2022,서울,질병,1,0,1
B70,2019,서울,질병,0,1,1
B70,2020,서울,질병,1,0,1
B70,2022,서울,질병,1,0,1
B70,2022,인천,질병,0,2,2
B75,2020,서울,질병,0,1,1
B81,2021,대구,질병,1,0,1
B83,2019,서울,질병,2,0,2
B83,2020,서울,질병,1,0,1
B83,2021,서울,질병,0,2,2
B83,2022,서울,질병,3,0,3
B83,2023,서울,질병,3,0,3
B86,2019,광주,질병,1,0,1
B86,2019,대전,질병,6,2,8
B86,2019,부산,질병,1,0,1
B86,2019,서울,질병,7,4,11
B86,2020,대구,질병,1,2,3
B86,2020,대전,질병,15,2,17
B86,2020,서울,질병,6,4,10
B86,2021,대전,질병,4,1,5
B86,2021,서울,질병,1,2,3
B86,2022,대구,질병,1,2,3
B86,2022,서울,질병,2,4,6
B86,2023,대구,질병,2,2,4
B86,2023,서울,질병,7,7,14
B87,2021,서울,질병,1,0,1
B88,2023,서울,질병,1,1,2
B89,2020,서울,질병,0,1,1
B89,2021,서울,질병,0,1,1
B90,2019,광주,질병,1,1,2
B90,2019,대구,질병,5,0,5
B90,2019,대전,질병,0,2,2
B90,2019,서울,질병,7,7,14
B90,2020,광주,질병,1,1,2
B90,2020,대구,질병,1,2,3
B90,2020,서울,질병,3,5,8
B90,2020,인천,질병,1,0,1
B90,2021,광주,질병,0,2,2
B90,2021,서울,질병,14,15,29
B90,2022,서울,질병,6,11,17
B90,2023,부산,질병,1,0,1
B90,2023,서울,질병,5,3,8
B91,2019,대전,질병,0,1,1
B91,2019,서울,질병,0,1,1
B94,2020,대구,질병,1,0,1
B94,2021,대구,질병,2,0,2
B94,2022,대구,질병,2,0,2
B95,2019,광주,질병,1,0,1
B95,2019,대구,질병,8,20,28
B95,2019,서울,질병,183,138,321
B95,2020,대구,질병,28,1,29
B95,2020,대전,질병,0,1,1
B95,2020,서울,질병,197,143,340
B95,2021,광주,질병,1,0,1
B95,2021,대구,질병,5,21,26
B95,2021,서울,질병,133,97,230
B95,2022,대구,질병,27,4,31
B95,2022,서울,질병,175,151,326
B95,2023,광주,질병,1,0,1
B95,2023,대구,질병,9,14,23
B95,2023,서울,질병,214,127,341
B96,2019,광주,질병,0,3,3
B96,2019,대구,질병,66,92,158
B96,2019,대전,질병,0,1,1
B96,2019,서울,질병,391,324,715
B96,2020,대구,질병,54,28,82
B96,2020,서울,질병,426,400,826
B96,2021,대구,질병,30,42,72
B96,2021,서울,질병,249,198,447
B96,2022,대구,질병,51,30,81
B96,2022,서울,질병,259,280,539
B96,2023,대구,질병,64,60,124
B96,2023,서울,질병,378,365,743
B97,2020,서울,질병,1,1,2
B97,2021,서울,질병,0,3,3
B97,2022,서울,질병,1,0,1
B98,2019,대전,질병,2,0,2
B98,2019,서울,질병,12,21,33
B98,2020,대전,질병,1,0,1
B98,2020,서울,질병,18,20,38
B98,2021,대전,질병,6,0,6
B98,2021,서울,질병,2,11,13
B98,2022,서울,질병,11,8,19
B98,2023,대전,질병,1,0,1
B98,2023,서울,질병,13,22,35
B99,2020,대전,질병,1,0,1
B99,2022,서울,질병,1,0,1
C00,2023,대전,질병,0,1,1
C00,2023,서울,질병,1,0,1
C01,2019,부산,질병,0,1,1
C01,2019,서울,질병,1,1,2
C01,2020,광주,질병,0,1,1
C01,2020,서울,질병,5,1,6
C01,2021,서울,질병,4,2,6
C01,2022,서울,질병,1,3,4
C01,2023,서울,질병,1,0,1
C02,2019,부산,질병,1,0,1
C02,2019,서울,질병,8,1,9
C02,2020,광주,질병,0,2,2
C02,2020,서울,질병,4,2,6
C02,2021,광주,질병,0,2,2
C02,2021,대구,질병,0,1,1
C02,2021,서울,질병,5,0,5
C02,2022,광주,질병,1,0,1
C02,2022,대구,질병,1,0,1
C02,2022,서울,질병,3,6,9
C02,2023,광주,질병,0,3,3
C02,2023,대구,질병,0,1,1
C02,2023,부산,질병,1,0,1
C02,2023,서울,질병,1,0,1
C03,2020,대전,질병,0,1,1
C03,2021,대전,질병,0,1,1
C03,2021,서울,질병,0,1,1
C03,2022,부산,질병,1,0,1
C03,2022,서울,질병,0,1,1
C04,2019,대구,질병,1,0,1
C04,2019,서울,질병,1,0,1
C04,2020,서울,질병,3,0,3
C04,2023,부산,질병,0,1,1
C04,2023,서울,질병,1,1,2
C05,2020,서울,질병,1,0,1
C05,2021,대전,질병,0,1,1
C05,2021,서울,질병,1,0,1
C05,2023,광주,질병,0,1,1
C05,2023,서울,질병,1,0,1
C06,2019,대구,질병,0,3,3
C06,2019,대전,질병,0,1,1
C06,2019,부산,질병,0,2,2
C06,2019,서울,질병,2,0,2
C06,2020,대전,질병,0,1,1
C06,2020,서울,질병,1,1,2
C06,2021,대구,질병,0,1,1
C06,2022,광주,질병,0,2,2
C06,2022,대구,질병,1,0,1
C06,2022,대전,질병,0,1,1
C06,2022,서울,질병,3,0,3
C06,2023,광주,질병,0,1,1
C06,2023,대전,질병,1,0,1
C06,2023,서울,질병,2,3,5
C07,2019,서울,질병,2,4,6
C07,2021,대구,질병,0,2,2
C07,2021,부산,질병,0,1,1
C07,2021,서울,질병,0,2,2
C07,2022,광주,질병,0,2,2
C07,2023,대구,질병,0,1,1
C07,2023,서울,질병,4,0,4
C08,2019,광주,질병,2,0,2
C08,2019,부산,질병,1,0,1
C08,2020,광주,질병,1,0,1
C08,2020,대구,질병,0,1,1
C08,2020,대전,질병,2,1,3
C08,2020,서울,질병,0,3,3
C08,2021,광주,질병,1,3,4
C08,2021,대구,질병,1,0,1
C08,2021,대전,질병,3,0,3
C08,2021,서울,질병,1,0,1
C08,2022,대전,질병,1,0,1
C08,2022,부산,질병,0,1,1
C08,2022,서울,질병,2,4,6
C08,2023,서울,질병,7,0,7
C09,2019,광주,질병,0,1,1
C09,2019,대구,질병,0,1,1
C09,2019,대전,질병,0,2,2
C09,2019,부산,질병,1,0,1
C09,2019,서울,질병,10,6,16
C09,2020,대전,질병,0,1,1
C09,2020,서울,질병,8,5,13
C09,2021,서울,질병,3,2,5
C09,2022,부산,질병,1,0,1
C09,2022,서울,질병,9,6,15
C09,2023,대구,질병,0,1,1
C09,2023,서울,질병,1,4,5
C10,2019,대구,질병,1,0,1
C10,2019,부산,질병,0,2,2
C10,2019,서울,질병,2,2,4
C10,2020,광주,질병,0,1,1
C10,2020,대구,질병,1,0,1
C10,2020,서울,질병,4,3,7
C10,2021,광주,질병,0,1,1
C10,2021,서울,질병,2,0,2
C10,2022,대구,질병,2,1,3
C10,2022,부산,질병,1,0,1
C10,2023,광주,질병,0,1,1
C10,2023,대구,질병,0,1,1
C11,2019,부산,질병,1,0,1
C11,2019,서울,질병,3,3,6
C11,2020,대전,질병,0,1,1
C11,2020,서울,질병,1,1,2
C11,2021,광주,질병,0,1,1
C11,2021,대구,질병,0,1,1
C11,2021,부산,질병,1,0,1
C11,2021,서울,질병,2,1,3
C11,2022,광주,질병,0,2,2
C11,2022,대구,질병,1,0,1
C11,2022,서울,질병,1,1,2
C11,2023,대구,질병,0,1,1
C11,2023,서울,질병,2,4,6
C12,2019,대전,질병,1,0,1
C12,2019,서울,질병,6,2,8
C12,2020,대전,질병,1,0,1
C12,2020,서울,질병,4,0,4
C12,2021,서울,질병,8,1,9
C12,2022,대구,질병,2,0,2
C12,2022,서울,질병,5,0,5
C12,2023,대구,질병,0,1,1
C12,2023,서울,질병,2,1,3
C13,2019,광주,질병,1,2,3
C13,2019,부산,질병,0,1,1
C13,2019,서울,질병,10,2,12
C13,2020,광주,질병,2,0,2
C13,2020,서울,질병,9,4,13
C13,2021,광주,질병,7,0,7
C13,2021,대전,질병,1,1,2
C13,2021,부산,질병,0,1,1
C13,2021,서울,질병,5,5,10
C13,2022,광주,질병,2,1,3
C13,2022,부산,질병,0,1,1
C13,2022,서울,질병,3,1,4
C13,2023,광주,질병,2,3,5
C13,2023,대구,질병,2,0,2
C13,2023,대전,질병,0,1,1
C13,2023,서울,질병,1,1,2
C14,2019,부산,질병,0,1,1
C14,2019,서울,질병,1,0,1
C14,2021,광주,질병,0,1,1
C14,2021,부산,질병,0,1,1
C14,2021,서울,질병,2,0,2
C14,2022,부산,질병,0,1,1
C14,2022,서울,질병,2,0,2
C15,2019,광주,질병,4,5,9
C15,2019,대구,질병,1,3,4
C15,2019,대전,질병,7,2,9
C15,2019,부산,질병,6,8,14
C15,2019,서울,질병,28,19,47
C15,2019,인천,질병,1,1,2
C15,2020,광주,질병,2,8,10
C15,2020,대구,질병,3,0,3
C15,2020,대전,질병,2,5,7
C15,2020,서울,질병,44,26,70
C15,2020,인천,질병,2,0,2
C15,2021,광주,질병,3,3,6
C15,2021,대구,질병,6,2,8
C15,2021,대전,질병,1,5,6
C15,2021,부산,질병,7,3,10
C15,2021,서울,질병,37,9,46
C15,2022,광주,질병,4,7,11
C15,2022,대구,질병,4,2,6
C15,2022,대전,질병,0,7,7
C15,2022,부산,질병,3,4,7
C15,2022,서울,질병,56,18,74
C15,2022,인천,질병,0,1,1
C15,2023,광주,질병,2,7,9
C15,2023,대구,질병,3,6,9
C15,2023,대전,질병,6,2,8
C15,2023,부산,질병,1,0,1
C15,2023,서울,질병,32,15,47
C16,2019,광주,질병,95,45,140
C16,2019,대구,질병,20,28,48
C16,2019,대전,질병,51,54,105
C16,2019,부산,질병,45,36,81
C16,2019,서울,질병,190,119,309
C16,2019,인천,질병,6,2,8
C16,2020,광주,질병,68,53,121
C16,2020,대구,질병,17,29,46
C16,2020,대전,질병,30,34,64
C16,2020,서울,질병,161,124,285
C16,2020,인천,질병,1,0,1
C16,2021,광주,질병,56,64,120
C16,2021,대구,질병,27,26,53
C16,2021,대전,질병,53,49,102
C16,2021,부산,질병,55,29,84
C16,2021,서울,질병,165,109,274
C16,2021,인천,질병,7,6,13
C16,2022,광주,질병,47,43,90
C16,2022,대구,질병,33,21,54
C16,2022,대전,질병,30,37,67
C16,2022,부산,질병,74,23,97
C16,2022,서울,질병,184,124,308
C16,2022,인천,질병,1,0,1
C16,2023,광주,질병,24,65,89
C16,2023,대구,질병,14,22,36
C16,2023,대전,질병,21,41,62
C16,2023,부산,질병,66,16,82
C16,2023,서울,질병,191,118,309
C17,2019,대전,질병,0,1,1
C17,2019,부산,질병,2,2,4
C17,2019,서울,질병,8,4,12
C17,2020,광주,질병,0,2,2
C17,2020,대전,질병,0,1,1
C17,2020,서울,질병,9,5,14
C17,2021,광주,질병,4,4,8
C17,2021,대구,질병,2,1,3
C17,2021,대전,질병,4,1,5
C17,2021,부산,질병,1,3,4
C17,2021,서울,질병,6,1,7
C17,2022,광주,질병,2,2,4
C17,2022,대구,질병,1,0,1
C17,2022,대전,질병,0,4,4
C17,2022,서울,질병,5,4,9
C17,2023,광주,질병,7,2,9
C17,2023,대전,질병,0,3,3
C17,2023,서울,질병,7,2,9
C18,2019,광주,질병,51,45,96
C18,2019,대구,질병,4,18,22
C18,2019,대전,질병,35,34,69
C18,2019,부산,질병,54,20,74
C18,2019,서울,질병,274,130,404
C18,2019,인천,질병,3,4,7
C18,2020,광주,질병,71,65,136
C18,2020,대구,질병,3,10,13
C18,2020,대전,질병,64,53,117
C18,2020,서울,질병,239,184,423
C18,2020,인천,질병,1,4,5
C18,2021,광주,질병,77,47,124
C18,2021,대구,질병,4,20,24
C18,2021,대전,질병,47,42,89
C18,2021,부산,질병,46,16,62
C18,2021,서울,질병,234,106,340
C18,2021,인천,질병,3,3,6
C18,2022,광주,질병,59,33,92
C18,2022,대구,질병,12,18,30
C18,2022,대전,질병,34,43,77
C18,2022,부산,질병,17,18,35
C18,2022,서울,질병,115,120,235
C18,2022,인천,질병,1,2,3
C18,2023,광주,질병,47,37,84
C18,2023,대구,질병,4,12,16
C18,2023,대전,질병,31,48,79
C18,2023,부산,질병,32,22,54
C18,2023,서울,질병,168,173,341
C18,2023,인천,질병,2,1,3
C19,2019,광주,질병,3,5,8
C19,2019,대구,질병,0,4,4
C19,2019,대전,질병,3,2,5
C19,2019,부산,질병,9,0,9
C19,2019,서울,질병,11,14,25
C19,2019,인천,질병,1,0,1
C19,2020,광주,질병,1,3,4
C19,2020,대전,질병,6,2,8
C19,2020,서울,질병,25,20,45
C19,2021,광주,질병,0,2,2
C19,2021,대구,질병,0,3,3
C19,2021,대전,질병,1,6,7
C19,2021,부산,질병,15,4,19
C19,2021,서울,질병,43,5,48
C19,2021,인천,질병,0,1,1
C19,2022,광주,질병,1,7,8
C19,2022,대구,질병,5,0,5
C19,2022,대전,질병,3,6,9
C19,2022,부산,질병,5,3,8
C19,2022,서울,질병,12,17,29
C19,2023,광주,질병,1,4,5
C19,2023,대구,질병,2,1,3
C19,2023,대전,질병,5,8,13
C19,2023,부산,질병,16,3,19
C19,2023,서울,질병,19,22,41
C20,2019,광주,질병,42,13,55
C20,2019,대구,질병,7,6,13
C20,2019,대전,질병,5,7,12
C20,2019,부산,질병,19,13,32
C20,2019,서울,질병,162,154,316
C20,2019,인천,질병,1,1,2
C20,2020,광주,질병,47,17,64
C20,2020,대구,질병,5,2,7
C20,2020,대전,질병,7,4,11
C20,2020,서울,질병,122,131,253
C20,2021,광주,질병,29,14,43
C20,2021,대구,질병,4,3,7
C20,2021,대전,질병,14,14,28
C20,2021,부산,질병,21,13,34
C20,2021,서울,질병,123,92,215
C20,2022,광주,질병,29,14,43
C20,2022,대구,질병,4,6,10
C20,2022,대전,질병,4,9,13
C20,2022,부산,질병,11,4,15
C20,2022,서울,질병,97,53,150
C20,2023,광주,질병,28,12,40
C20,2023,대구,질병,6,11,17
C20,2023,대전,질병,13,6,19
C20,2023,부산,질병,21,7,28
C20,2023,서울,질병,100,44,144
C21,2019,광주,질병,0,1,1
C21,2019,대전,질병,1,1,2
C21,2019,서울,질병,0,1,1
C21,2020,서울,질병,1,3,4
C21,2021,대전,질병,1,0,1
C21,2021,서울,질병,0,1,1
C21,2022,광주,질병,0,3,3
C21,2022,서울,질병,2,0,2
C21,2023,광주,질병,1,2,3
C22,2019,광주,질병,58,72,130
C22,2019,대구,질병,27,22,49
C22,2019,대전,질병,26,24,50
C22,2019,부산,질병,40,37,77
C22,2019,서울,질병,305,116,421
C22,2019,인천,질병,2,3,5
C22,2020,광주,질병,80,61,141
C22,2020,대구,질병,34,28,62
C22,2020,대전,질병,19,19,38
C22,2020,서울,질병,296,122,418
C22,2020,인천,질병,1,1,2
C22,2021,광주,질병,54,42,96
C22,2021,대구,질병,18,19,37
C22,2021,대전,질병,28,27,55
C22,2021,부산,질병,41,19,60
C22,2021,서울,질병,252,86,338
C22,2021,인천,질병,0,8,8
C22,2022,광주,질병,49,32,81
C22,2022,대구,질병,35,23,58
C22,2022,대전,질병,25,14,39
C22,2022,부산,질병,26,14,40
C22,2022,서울,질병,240,112,352
C22,2022,인천,질병,0,3,3
C22,2023,광주,질병,59,66,125
C22,2023,대구,질병,16,22,38
C22,2023,대전,질병,12,22,34
C22,2023,부산,질병,45,15,60
C22,2023,서울,질병,208,92,300
C22,2023,인천,질병,0,1,1
C23,2019,광주,질병,9,6,15
C23,2019,대구,질병,1,3,4
C23,2019,대전,질병,1,7,8
C23,2019,부산,질병,0,5,5
C23,2019,서울,질병,15,25,40
C23,2019,인천,질병,0,1,1
C23,2020,광주,질병,7,10,17
C23,2020,대구,질병,1,4,5
C23,2020,대전,질병,3,4,7
C23,2020,서울,질병,21,12,33
C23,2020,인천,질병,0,1,1
C23,2021,광주,질병,16,7,23
C23,2021,대구,질병,2,11,13
C23,2021,대전,질병,3,9,12
C23,2021,부산,질병,2,9,11
C23,2021,서울,질병,26,15,41
C23,2022,광주,질병,7,9,16
C23,2022,대구,질병,4,4,8
C23,2022,대전,질병,3,9,12
C23,2022,부산,질병,3,2,5
C23,2022,서울,질병,10,5,15
C23,2023,광주,질병,6,24,30
C23,2023,대구,질병,0,6,6
C23,2023,대전,질병,0,13,13
C23,2023,부산,질병,1,4,5
C23,2023,서울,질병,5,13,18
C24,2019,광주,질병,7,5,12
C24,2019,대구,질병,8,6,14
C24,2019,대전,질병,3,4,7
C24,2019,부산,질병,9,9,18
C24,2019,서울,질병,53,35,88
C24,2020,광주,질병,5,14,19
C24,2020,대구,질병,3,8,11
C24,2020,대전,질병,7,5,12
C24,2020,서울,질병,53,55,108
C24,2020,인천,질병,0,1,1
C24,2021,광주,질병,6,4,10
C24,2021,대구,질병,4,2,6
C24,2021,대전,질병,2,4,6
C24,2021,부산,질병,11,6,17
C24,2021,서울,질병,54,21,75
C24,2022,광주,질병,4,7,11
C24,2022,대구,질병,8,5,13
C24,2022,대전,질병,6,6,12
C24,2022,부산,질병,9,6,15
C24,2022,서울,질병,62,8,70
C24,2023,광주,질병,6,8,14
C24,2023,대구,질병,3,12,15
C24,2023,대전,질병,0,4,4
C24,2023,부산,질병,11,5,16
C24,2023,서울,질병,47,27,74
C25,2019,광주,질병,26,24,50
C25,2019,대구,질병,12,17,29
C25,2019,대전,질병,4,20,24
C25,2019,부산,질병,7,21,28
C25,2019,서울,질병,76,74,150
C25,2019,인천,질병,14,0,14
C25,2020,광주,질병,39,57,96
C25,2020,대구,질병,10,16,26
C25,2020,대전,질병,10,15,25
C25,2020,서울,질병,94,43,137
C25,2020,인천,질병,2,0,2
C25,2021,광주,질병,25,24,49
C25,2021,대구,질병,13,14,27
C25,2021,대전,질병,6,17,23
C25,2021,부산,질병,6,21,27
C25,2021,서울,질병,71,50,121
C25,2021,인천,질병,6,0,6
C25,2022,광주,질병,37,20,57
C25,2022,대구,질병,7,12,19
C25,2022,대전,질병,13,31,44
C25,2022,부산,질병,10,14,24
C25,2022,서울,질병,60,50,110
C25,2022,인천,질병,0,2,2
C25,2023,광주,질병,50,42,92
C25,2023,대구,질병,14,25,39
C25,2023,대전,질병,8,45,53
C25,2023,부산,질병,8,14,22
C25,2023,서울,질병,112,90,202
C25,2023,인천,질병,0,1,1
C26,2019,부산,질병,0,5,5
C26,2019,인천,질병,0,1,1
C26,2021,광주,질병,0,1,1
C26,2023,광주,질병,0,1,1
C30,2019,광주,질병,0,1,1
C30,2019,서울,질병,2,1,3
C30,2020,광주,질병,1,1,2
C30,2020,서울,질병,1,0,1
C30,2021,서울,질병,1,1,2
C30,2022,대구,질병,1,0,1
C30,2022,서울,질병,1,0,1
C30,2023,서울,질병,5,1,6
C31,2019,광주,질병,0,2,2
C31,2019,대전,질병,0,1,1
C31,2019,서울,질병,4,0,4
C31,2020,광주,질병,0,2,2
C31,2020,서울,질병,1,0,1
C31,2023,광주,질병,0,1,1
C32,2019,광주,질병,1,0,1
C32,2019,대구,질병,5,0,5
C32,2019,대전,질병,0,1,1
C32,2019,서울,질병,22,4,26
C32,2020,광주,질병,0,2,2
C32,2020,대구,질병,4,0,4
C32,2020,대전,질병,0,1,1
C32,2020,서울,질병,19,10,29
C32,2021,광주,질병,4,0,4
C32,2021,대구,질병,2,1,3
C32,2021,대전,질병,2,1,3
C32,2021,부산,질병,2,0,2
C32,2021,서울,질병,30,13,43
C32,2022,대구,질병,2,0,2
C32,2022,부산,질병,2,1,3
C32,2022,서울,질병,10,8,18
C32,2023,광주,질병,0,2,2
C32,2023,대구,질병,1,1,2
C32,2023,대전,질병,0,1,1
C32,2023,서울,질병,14,5,19
C32,2023,인천,질병,2,0,2
C33,2019,서울,질병,1,0,1
C34,2019,광주,질병,89,81,170
C34,2019,대구,질병,62,34,96
C34,2019,대전,질병,33,45,78
C34,2019,부산,질병,26,33,59
C34,2019,서울,질병,564,301,865
C34,2019,인천,질병,1,6,7
C34,2020,광주,질병,62,104,166
C34,2020,대구,질병,37,34,71
C34,2020,대전,질병,24,29,53
C34,2020,서울,질병,408,240,648
C34,2020,인천,질병,8,1,9
C34,2021,광주,질병,42,71,113
C34,2021,대구,질병,32,51,83
C34,2021,대전,질병,23,43,66
C34,2021,부산,질병,36,35,71
C34,2021,서울,질병,372,179,551
C34,2021,인천,질병,3,3,6
C34,2022,광주,질병,32,56,88
C34,2022,대구,질병,56,37,93
C34,2022,대전,질병,22,39,61
C34,2022,부산,질병,32,37,69
C34,2022,서울,질병,435,243,678
C34,2022,인천,질병,7,3,10
C34,2023,광주,질병,28,51,79
C34,2023,대구,질병,42,45,87
C34,2023,대전,질병,39,36,75
C34,2023,부산,질병,30,32,62
C34,2023,서울,질병,598,251,849
C34,2023,인천,질병,3,5,8
C37,2019,광주,질병,0,1,1
C37,2019,대구,질병,2,0,2
C37,2019,부산,질병,1,0,1
C37,2019,서울,질병,15,0,15
C37,2020,서울,질병,10,2,12
C37,2021,광주,질병,0,2,2
C37,2021,대전,질병,2,0,2
C37,2021,서울,질병,4,5,9
C37,2022,대구,질병,1,0,1
C37,2022,대전,질병,1,1,2
C37,2022,서울,질병,6,1,7
C37,2023,대전,질병,0,1,1
C37,2023,서울,질병,4,1,5
C38,2019,광주,질병,0,1,1
C38,2019,대구,질병,1,0,1
C38,2019,서울,질병,1,0,1
C38,2020,광주,질병,0,1,1
C38,2020,대전,질병,1,0,1
C38,2020,서울,질병,1,1,2
C38,2021,대전,질병,0,2,2
C38,2021,부산,질병,1,0,1
C38,2022,광주,질병,0,2,2
C40,2019,대구,질병,2,0,2
C40,2019,서울,질병,1,1,2
C40,2020,대전,질병,0,1,1
C40,2020,서울,질병,0,3,3
C40,2021,대전,질병,0,1,1
C40,2022,광주,질병,0,1,1
C40,2022,서울,질병,0,1,1
C41,2019,광주,질병,1,0,1
C41,2019,서울,질병,2,2,4
C41,2020,대구,질병,0,2,2
C41,2020,대전,질병,0,1,1
C41,2020,서울,질병,0,1,1
C41,2021,대구,질병,1,0,1
C41,2021,대전,질병,0,2,2
C41,2021,부산,질병,0,1,1
C41,2022,서울,질병,0,1,1
C41,2022,인천,질병,0,1,1
C41,2023,대구,질병,0,1,1
C43,2019,광주,질병,0,3,3
C43,2019,대구,질병,1,1,2
C43,2019,대전,질병,0,2,2
C43,2019,서울,질병,4,4,8
C43,2020,광주,질병,0,2,2
C43,2020,대구,질병,0,2,2
C43,2020,대전,질병,0,1,1
C43,2020,서울,질병,7,1,8
C43,2021,광주,질병,0,2,2
C43,2021,대구,질병,0,3,3
C43,2021,대전,질병,0,1,1
C43,2021,서울,질병,3,1,4
C43,2022,광주,질병,0,3,3
C43,2022,서울,질병,4,0,4
C43,2023,광주,질병,1,1,2
C43,2023,대구,질병,0,1,1
C43,2023,서울,질병,10,1,11
C44,2019,대구,질병,4,1,5
C44,2019,대전,질병,0,3,3
C44,2019,부산,질병,0,1,1
C44,2019,서울,질병,14,9,23
C44,2020,광주,질병,0,1,1
C44,2020,대구,질병,0,2,2
C44,2020,대전,질병,1,0,1
C44,2020,서울,질병,12,8,20
C44,2021,대구,질병,1,1,2
C44,2021,대전,질병,1,2,3
C44,2021,서울,질병,8,5,13
C44,2021,인천,질병,1,0,1
C44,2022,광주,질병,0,1,1
C44,2022,대전,질병,2,3,5
C44,2022,부산,질병,0,1,1
C44,2022,서울,질병,11,1,12
C44,2023,광주,질병,1,1,2
C44,2023,대구,질병,1,3,4
C44,2023,대전,질병,1,1,2
C44,2023,부산,질병,0,1,1
C44,2023,서울,질병,18,4,22
C45,2019,광주,질병,1,1,2
C45,2019,부산,질병,1,1,2
C45,2019,서울,질병,2,2,4
C45,2020,광주,질병,0,1,1
C45,2020,대구,질병,1,1,2
C45,2020,서울,질병,1,1,2
C45,2021,광주,질병,1,0,1
C45,2022,서울,질병,11,2,13
C45,2023,광주,질병,0,1,1
C45,2023,대구,질병,0,2,2
C45,2023,부산,질병,0,1,1
C45,2023,서울,질병,4,2,6
C46,2019,대전,질병,0,1,1
C46,2019,부산,질병,0,1,1
C46,2019,서울,질병,1,0,1
C46,2020,대전,질병,0,1,1
C46,2020,서울,질병,2,0,2
C46,2021,서울,질병,8,0,8
C46,2022,서울,질병,3,0,3
C46,2023,서울,질병,3,0,3
C47,2019,부산,질병,0,1,1
C47,2019,서울,질병,1,0,1
C47,2021,서울,질병,2,0,2
C47,2022,광주,질병,0,1,1
C47,2022,대전,질병,0,1,1
C47,2022,부산,질병,0,1,1
C47,2022,서울,질병,2,0,2
C47,2023,광주,질병,0,1,1
C48,2019,광주,질병,1,0,1
C48,2019,서울,질병,3,0,3
C48,2020,광주,질병,0,4,4
C48,2020,대구,질병,1,0,1
C48,2020,서울,질병,0,1,1
C48,2020,인천,질병,0,1,1
C48,2021,광주,질병,0,2,2
C48,2021,대전,질병,1,1,2
C48,2021,서울,질병,2,4,6
C48,2022,광주,질병,0,1,1
C48,2022,대구,질병,2,0,2
C48,2022,대전,질병,0,3,3
C48,2022,서울,질병,5,1,6
C48,2023,대구,질병,0,2,2
C48,2023,대전,질병,0,3,3
C48,2023,서울,질병,3,3,6
C49,2019,광주,질병,3,1,4
C49,2019,대구,질병,3,1,4
C49,2019,대전,질병,1,2,3
C49,2019,서울,질병,25,12,37
C49,2020,광주,질병,4,6,10
C49,2020,대구,질병,1,1,2
C49,2020,서울,질병,8,11,19
C49,2021,광주,질병,3,5,8
C49,2021,대전,질병,1,0,1
C49,2021,부산,질병,1,0,1
C49,2021,서울,질병,8,4,12
C49,2022,광주,질병,0,1,1
C49,2022,대전,질병,1,0,1
C49,2022,부산,질병,3,3,6
C49,2022,서울,질병,6,4,10
C49,2023,광주,질병,0,2,2
C49,2023,대구,질병,0,2,2
C49,2023,대전,질병,0,3,3
C49,2023,부산,질병,2,0,2
C49,2023,서울,질병,6,8,14
C50,2019,광주,질병,1,10,11
C50,2019,대구,질병,0,3,3
C50,2019,대전,질병,0,2,2
C50,2019,부산,질병,0,5,5
C50,2019,서울,질병,2,46,48
C50,2020,광주,질병,0,17,17
C50,2020,대구,질병,0,4,4
C50,2020,대전,질병,0,6,6
C50,2020,서울,질병,0,53,53
C50,2021,광주,질병,0,8,8
C50,2021,대구,질병,0,5,5
C50,2021,대전,질병,0,1,1
C50,2021,부산,질병,1,3,4
C50,2021,서울,질병,1,50,51
C50,2022,광주,질병,0,8,8
C50,2022,대구,질병,3,0,3
C50,2022,대전,질병,0,10,10
C50,2022,부산,질병,0,4,4
C50,2022,서울,질병,1,46,47
C50,2023,광주,질병,0,5,5
C50,2023,대구,질병,0,4,4
C50,2023,대전,질병,0,9,9
C50,2023,부산,질병,0,3,3
C50,2023,서울,질병,5,71,76
C51,2021,서울,질병,0,5,5
C51,2022,서울,질병,0,2,2
C51,2023,서울,질병,0,1,1
C53,2019,광주,질병,0,2,2
C53,2019,대전,질병,0,3,3
C53,2019,서울,질병,0,11,11
C53,2020,광주,질병,0,2,2
C53,2020,대구,질병,0,2,2
C53,2020,대전,질병,0,2,2
C53,2020,서울,질병,0,5,5
C53,2021,광주,질병,0,2,2
C53,2021,대구,질병,0,3,3
C53,2021,대전,질병,0,3,3
C53,2021,부산,질병,0,2,2
C53,2021,서울,질병,0,4,4
C53,2022,광주,질병,0,4,4
C53,2022,대구,질병,1,0,1
C53,2022,대전,질병,0,4,4
C53,2022,부산,질병,0,1,1
C53,2022,서울,질병,0,8,8
C53,2023,광주,질병,0,2,2
C53,2023,대구,질병,0,4,4
C53,2023,대전,질병,0,6,6
C53,2023,부산,질병,0,2,2
C53,2023,서울,질병,0,9,9
C54,2019,광주,질병,0,2,2
C54,2019,대전,질병,0,1,1
C54,2019,부산,질병,0,1,1
C54,2019,서울,질병,0,25,25
C54,2020,대구,질병,0,1,1
C54,2020,서울,질병,0,44,44
C54,2021,광주,질병,0,1,1
C54,2021,대구,질병,0,1,1
C54,2021,대전,질병,0,2,2
C54,2021,부산,질병,0,1,1
C54,2021,서울,질병,0,41,41
C54,2022,광주,질병,0,3,3
C54,2022,대구,질병,1,0,1
C54,2022,대전,질병,0,1,1
C54,2022,서울,질병,0,23,23
C54,2023,광주,질병,0,1,1
C54,2023,대전,질병,0,1,1
C54,2023,서울,질병,0,16,16
C55,2019,서울,질병,0,5,5
C55,2020,서울,질병,0,1,1
C55,2021,광주,질병,0,1,1
C55,2021,대전,질병,0,1,1
C55,2022,대전,질병,0,1,1
C55,2023,광주,질병,0,1,1
C55,2023,대전,질병,0,1,1
C56,2019,광주,질병,0,8,8
C56,2019,대구,질병,0,1,1
C56,2019,대전,질병,0,2,2
C56,2019,부산,질병,0,1,1
C56,2019,서울,질병,0,41,41
C56,2019,인천,질병,0,3,3
C56,2020,광주,질병,0,5,5
C56,2020,대구,질병,0,5,5
C56,2020,대전,질병,0,4,4
C56,2020,서울,질병,0,42,42
C56,2021,광주,질병,0,5,5
C56,2021,대구,질병,0,2,2
C56,2021,대전,질병,0,4,4
C56,2021,부산,질병,0,4,4
C56,2021,서울,질병,0,44,44
C56,2022,광주,질병,0,3,3
C56,2022,대구,질병,7,0,7
C56,2022,대전,질병,0,5,5
C56,2022,부산,질병,0,2,2
C56,2022,서울,질병,0,24,24
C56,2023,광주,질병,0,2,2
C56,2023,대구,질병,0,3,3
C56,2023,대전,질병,0,4,4
C56,2023,부산,질병,0,4,4
C56,2023,서울,질병,2,33,35
C57,2019,서울,질병,0,9,9
C57,2020,서울,질병,0,15,15
C57,2021,서울,질병,0,6,6
C57,2022,광주,질병,0,1,1
C57,2022,서울,질병,0,1,1
C57,2023,광주,질병,0,1,1
C58,2020,광주,질병,0,1,1
C60,2019,부산,질병,1,0,1
C60,2019,서울,질병,0,1,1
C60,2020,서울,질병,0,1,1
C60,2022,광주,질병,0,1,1
C60,2022,서울,질병,1,0,1
C61,2019,광주,질병,36,16,52
C61,2019,대구,질병,86,55,141
C61,2019,대전,질병,48,26,74
C61,2019,부산,질병,62,25,87
C61,2019,서울,질병,236,192,428
C61,2019,인천,질병,12,14,26
C61,2020,광주,질병,51,43,94
C61,2020,대구,질병,77,27,104
C61,2020,대전,질병,41,25,66
C61,2020,서울,질병,175,125,300
C61,2020,인천,질병,23,18,41
C61,2021,광주,질병,87,50,137
C61,2021,대구,질병,85,38,123
C61,2021,대전,질병,20,19,39
C61,2021,부산,질병,49,22,71
C61,2021,서울,질병,250,118,368
C61,2021,인천,질병,22,8,30
C61,2022,광주,질병,122,67,189
C61,2022,대구,질병,65,20,85
C61,2022,대전,질병,34,19,53
C61,2022,부산,질병,44,9,53
C61,2022,서울,질병,355,145,500
C61,2022,인천,질병,11,6,17
C61,2023,광주,질병,152,73,225
C61,2023,대구,질병,61,32,93
C61,2023,대전,질병,37,21,58
C61,2023,부산,질병,63,21,84
C61,2023,서울,질병,465,218,683
C61,2023,인천,질병,13,13,26
C62,2019,서울,질병,6,0,6
C62,2020,서울,질병,2,1,3
C62,2021,서울,질병,3,0,3
C63,2019,서울,질병,1,1,2
C63,2020,서울,질병,5,1,6
C63,2021,서울,질병,10,2,12
C63,2022,서울,질병,3,1,4
C63,2023,광주,질병,2,0,2
C64,2019,광주,질병,2,5,7
C64,2019,대구,질병,9,3,12
C64,2019,대전,질병,0,3,3
C64,2019,부산,질병,4,3,7
C64,2019,서울,질병,56,24,80
C64,2019,인천,질병,6,0,6
C64,2020,광주,질병,2,4,6
C64,2020,대구,질병,2,2,4
C64,2020,대전,질병,1,1,2
C64,2020,서울,질병,43,32,75
C64,2020,인천,질병,1,0,1
C64,2021,광주,질병,4,3,7
C64,2021,대구,질병,2,4,6
C64,2021,대전,질병,2,3,5
C64,2021,부산,질병,8,1,9
C64,2021,서울,질병,43,23,66
C64,2022,광주,질병,4,3,7
C64,2022,대구,질병,3,4,7
C64,2022,대전,질병,1,7,8
C64,2022,부산,질병,7,4,11
C64,2022,서울,질병,43,25,68
C64,2023,광주,질병,3,13,16
C64,2023,대구,질병,0,7,7
C64,2023,대전,질병,1,1,2
C64,2023,부산,질병,1,1,2
C64,2023,서울,질병,50,22,72
C65,2019,광주,질병,0,2,2
C65,2019,대구,질병,2,1,3
C65,2019,대전,질병,0,1,1
C65,2019,부산,질병,1,2,3
C65,2019,서울,질병,11,4,15
C65,2020,광주,질병,1,1,2
C65,2020,대구,질병,2,0,2
C65,2020,서울,질병,7,6,13
C65,2021,광주,질병,2,8,10
C65,2021,부산,질병,0,2,2
C65,2021,서울,질병,16,9,25
C65,2022,광주,질병,1,4,5
C65,2022,부산,질병,2,2,4
C65,2022,서울,질병,11,3,14
C65,2023,광주,질병,0,2,2
C65,2023,대구,질병,0,4,4
C65,2023,서울,질병,5,8,13
C66,2019,광주,질병,0,1,1
C66,2019,대구,질병,2,0,2
C66,2019,대전,질병,0,1,1
C66,2019,부산,질병,2,3,5
C66,2019,서울,질병,21,13,34
C66,2020,광주,질병,1,2,3
C66,2020,대구,질병,1,4,5
C66,2020,대전,질병,0,1,1
C66,2020,서울,질병,14,13,27
C66,2021,광주,질병,5,1,6
C66,2021,대전,질병,0,1,1
C66,2021,부산,질병,1,0,1
C66,2021,서울,질병,15,5,20
C66,2021,인천,질병,0,3,3
C66,2022,광주,질병,4,4,8
C66,2022,대구,질병,2,1,3
C66,2022,대전,질병,1,1,2
C66,2022,부산,질병,1,1,2
C66,2022,서울,질병,8,4,12
C66,2023,광주,질병,2,6,8
C66,2023,대구,질병,2,1,3
C66,2023,대전,질병,0,1,1
C66,2023,부산,질병,2,0,2
C66,2023,서울,질병,11,14,25
C67,2019,광주,질병,50,18,68
C67,2019,대구,질병,30,10,40
C67,2019,대전,질병,3,4,7
C67,2019,부산,질병,16,4,20
C67,2019,서울,질병,85,47,132
C67,2019,인천,질병,7,30,37
C67,2020,광주,질병,51,24,75
C67,2020,대구,질병,21,10,31
C67,2020,대전,질병,3,3,6
C67,2020,서울,질병,102,70,172
C67,2020,인천,질병,24,35,59
C67,2021,광주,질병,57,31,88
C67,2021,대구,질병,11,9,20
C67,2021,대전,질병,9,6,15
C67,2021,부산,질병,16,5,21
C67,2021,서울,질병,99,47,146
C67,2021,인천,질병,15,21,36
C67,2022,광주,질병,66,35,101
C67,2022,대구,질병,6,4,10
C67,2022,대전,질병,10,3,13
C67,2022,부산,질병,15,7,22
C67,2022,서울,질병,92,53,145
C67,2022,인천,질병,21,20,41
C67,2023,광주,질병,83,51,134
C67,2023,대구,질병,6,9,15
C67,2023,대전,질병,7,5,12
C67,2023,부산,질병,9,2,11
C67,2023,서울,질병,120,57,177
C67,2023,인천,질병,39,31,70
C68,2019,서울,질병,3,1,4
C68,2020,서울,질병,11,3,14
C68,2021,광주,질병,1,0,1
C68,2021,대구,질병,0,1,1
C68,2021,서울,질병,5,1,6
C68,2022,서울,질병,1,2,3
C68,2023,서울,질병,3,3,6
C69,2019,광주,질병,2,0,2
C69,2019,서울,질병,0,1,1
C69,2022,서울,질병,0,2,2
C69,2023,대구,질병,0,1,1
C69,2023,서울,질병,2,0,2
C70,2019,서울,질병,2,0,2
C70,2020,서울,질병,2,0,2
C70,2021,대구,질병,1,0,1
C70,2022,광주,질병,3,1,4
C70,2022,부산,질병,0,1,1
C70,2023,광주,질병,1,3,4
C70,2023,부산,질병,0,2,2
C71,2019,광주,질병,3,7,10
C71,2019,대구,질병,4,1,5
C71,2019,대전,질병,5,3,8
C71,2019,부산,질병,1,3,4
C71,2019,서울,질병,14,16,30
C71,2020,광주,질병,1,7,8
C71,2020,대구,질병,1,1,2
C71,2020,대전,질병,3,3,6
C71,2020,서울,질병,11,6,17
C71,2021,광주,질병,5,4,9
C71,2021,대구,질병,1,3,4
C71,2021,대전,질병,0,2,2
C71,2021,부산,질병,1,2,3
C71,2021,서울,질병,5,7,12
C71,2022,광주,질병,1,8,9
C71,2022,대구,질병,5,0,5
C71,2022,대전,질병,0,3,3
C71,2022,부산,질병,3,3,6
C71,2022,서울,질병,14,18,32
C71,2023,광주,질병,4,6,10
C71,2023,대구,질병,1,3,4
C71,2023,대전,질병,1,5,6
C71,2023,부산,질병,0,6,6
C71,2023,서울,질병,7,11,18
C72,2021,대구,질병,1,0,1
C72,2023,광주,질병,0,1,1
C73,2019,광주,질병,5,8,13
C73,2019,대구,질병,0,1,1
C73,2019,대전,질병,2,3,5
C73,2019,부산,질병,0,1,1
C73,2019,서울,질병,19,31,50
C73,2020,광주,질병,5,5,10
C73,2020,대구,질병,1,1,2
C73,2020,대전,질병,2,6,8
C73,2020,서울,질병,18,26,44
C73,2021,광주,질병,4,4,8
C73,2021,대구,질병,0,1,1
C73,2021,대전,질병,1,3,4
C73,2021,부산,질병,0,1,1
C73,2021,서울,질병,14,17,31
C73,2022,광주,질병,2,4,6
C73,2022,부산,질병,2,0,2
C73,2022,서울,질병,10,19,29
C73,2023,광주,질병,4,9,13
C73,2023,대전,질병,1,0,1
C73,2023,부산,질병,0,1,1
C73,2023,서울,질병,16,17,33
C73,2023,인천,질병,0,1,1
C74,2019,광주,질병,0,1,1
C74,2020,서울,질병,0,1,1
C74,2021,서울,질병,1,2,3
C74,2022,서울,질병,0,1,1
C74,2023,광주,질병,0,1,1
C74,2023,서울,질병,1,0,1
C75,2019,광주,질병,0,1,1
C75,2020,서울,질병,1,0,1
C75,2021,서울,질병,1,0,1
C75,2023,서울,질병,1,0,1
C76,2019,대구,질병,1,0,1
C76,2019,부산,질병,0,1,1
C76,2020,서울,질병,0,2,2
C76,2021,광주,질병,0,1,1
C76,2021,서울,질병,1,1,2
C77,2019,광주,질병,1,0,1
C77,2019,대구,질병,0,2,2
C77,2019,대전,질병,0,1,1
C77,2019,서울,질병,1277,737,2014
C77,2020,대전,질병,1,0,1
C77,2020,서울,질병,1097,784,1881
C77,2021,대구,질병,0,12,12
C77,2021,대전,질병,0,1,1
C77,2021,부산,질병,1,0,1
C77,2021,서울,질병,1098,630,1728
C77,2022,광주,질병,1,1,2
C77,2022,대구,질병,7,2,9
C77,2022,대전,질병,0,4,4
C77,2022,서울,질병,925,601,1526
C77,2023,광주,질병,2,1,3
C77,2023,대구,질병,2,19,21
C77,2023,대전,질병,0,3,3
C77,2023,서울,질병,1161,595,1756
C78,2019,광주,질병,3,2,5
C78,2019,대구,질병,7,23,30
C78,2019,대전,질병,11,48,59
C78,2019,부산,질병,0,2,2
C78,2019,서울,질병,1269,814,2083
C78,2019,인천,질병,0,1,1
C78,2020,대구,질병,12,6,18
C78,2020,대전,질병,15,37,52
C78,2020,서울,질병,1095,798,1893
C78,2021,광주,질병,3,1,4
C78,2021,대구,질병,13,70,83
C78,2021,대전,질병,22,61,83
C78,2021,부산,질병,2,0,2
C78,2021,서울,질병,1077,585,1662
C78,2022,광주,질병,2,0,2
C78,2022,대구,질병,27,20,47
C78,2022,대전,질병,34,109,143
C78,2022,부산,질병,0,1,1
C78,2022,서울,질병,948,572,1520
C78,2023,광주,질병,2,3,5
C78,2023,대구,질병,9,105,114
C78,2023,대전,질병,22,135,157
C78,2023,부산,질병,2,6,8
C78,2023,서울,질병,1175,770,1945
C79,2019,광주,질병,3,5,8
C79,2019,대구,질병,21,14,35
C79,2019,대전,질병,8,23,31
C79,2019,부산,질병,1,0,1
C79,2019,서울,질병,520,339,859
C79,2020,광주,질병,9,3,12
C79,2020,대구,질병,21,7,28
C79,2020,대전,질병,5,25,30
C79,2020,서울,질병,375,291,666
C79,2020,인천,질병,0,1,1
C79,2021,광주,질병,2,2,4
C79,2021,대구,질병,7,34,41
C79,2021,대전,질병,5,36,41
C79,2021,서울,질병,357,234,591
C79,2022,광주,질병,1,4,5
C79,2022,대구,질병,31,16,47
C79,2022,대전,질병,9,43,52
C79,2022,부산,질병,1,0,1
C79,2022,서울,질병,337,240,577
C79,2022,인천,질병,1,1,2
C79,2023,광주,질병,0,2,2
C79,2023,대구,질병,16,64,80
C79,2023,대전,질병,10,37,47
C79,2023,부산,질병,1,1,2
C79,2023,서울,질병,478,258,736
C80,2019,광주,질병,4,1,5
C80,2019,대구,질병,1,0,1
C80,2019,대전,질병,2,4,6
C80,2019,서울,질병,7,8,15
C80,2019,인천,질병,1,0,1
C80,2020,광주,질병,1,4,5
C80,2020,대구,질병,1,0,1
C80,2020,대전,질병,0,3,3
C80,2020,서울,질병,4,5,9
C80,2020,인천,질병,0,1,1
C80,2021,광주,질병,5,3,8
C80,2021,대구,질병,1,3,4
C80,2021,대전,질병,0,1,1
C80,2021,부산,질병,2,0,2
C80,2021,서울,질병,3,3,6
C80,2022,광주,질병,2,5,7
C80,2022,대구,질병,1,2,3
C80,2022,대전,질병,1,1,2
C80,2022,서울,질병,6,3,9
C80,2023,광주,질병,1,3,4
C80,2023,대구,질병,0,4,4
C80,2023,대전,질병,1,1,2
C80,2023,부산,질병,1,0,1
C80,2023,서울,질병,5,6,11
C80,2023,인천,질병,0,1,1
C81,2019,부산,질병,3,0,3
C81,2019,서울,질병,2,0,2
C81,2020,대구,질병,1,0,1
C81,2020,서울,질병,2,0,2
C81,2021,부산,질병,1,0,1
C81,2021,서울,질병,2,1,3
C81,2022,서울,질병,0,1,1
C81,2023,서울,질병,2,1,3
C82,2019,서울,질병,14,0,14
C82,2020,서울,질병,1,5,6
C82,2021,대구,질병,1,0,1
C82,2021,부산,질병,1,0,1
C82,2021,서울,질병,0,5,5
C82,2022,대구,질병,1,0,1
C82,2022,서울,질병,1,2,3
C82,2023,서울,질병,10,3,13
C83,2019,광주,질병,0,2,2
C83,2019,대구,질병,0,1,1
C83,2019,대전,질병,4,0,4
C83,2019,부산,질병,0,2,2
C83,2019,서울,질병,46,37,83
C83,2020,광주,질병,0,3,3
C83,2020,대구,질병,1,0,1
C83,2020,서울,질병,36,14,50
C83,2021,광주,질병,2,5,7
C83,2021,대구,질병,0,3,3
C83,2021,대전,질병,0,1,1
C83,2021,서울,질병,32,9,41
C83,2022,광주,질병,1,2,3
C83,2022,대구,질병,2,0,2
C83,2022,대전,질병,2,3,5
C83,2022,부산,질병,1,0,1
C83,2022,서울,질병,22,7,29
C83,2023,광주,질병,2,3,5
C83,2023,대구,질병,0,1,1
C83,2023,대전,질병,1,4,5
C83,2023,서울,질병,29,15,44
C84,2020,광주,질병,0,1,1
C84,2020,서울,질병,2,6,8
C84,2021,서울,질병,0,1,1
C84,2022,광주,질병,0,1,1
C84,2022,서울,질병,1,1,2
C84,2023,서울,질병,1,2,3
C85,2019,광주,질병,13,3,16
C85,2019,대구,질병,5,0,5
C85,2019,부산,질병,1,3,4
C85,2019,서울,질병,9,14,23
C85,2020,광주,질병,13,3,16
C85,2020,대구,질병,1,2,3
C85,2020,서울,질병,18,8,26
C85,2021,광주,질병,9,3,12
C85,2021,대구,질병,2,5,7
C85,2021,대전,질병,2,1,3
C85,2021,부산,질병,1,2,3
C85,2021,서울,질병,9,5,14
C85,2022,광주,질병,3,1,4
C85,2022,대구,질병,2,0,2
C85,2022,부산,질병,1,1,2
C85,2022,서울,질병,3,1,4
C85,2023,광주,질병,1,1,2
C85,2023,대구,질병,0,1,1
C85,2023,대전,질병,1,0,1
C85,2023,부산,질병,0,6,6
C85,2023,서울,질병,2,3,5
C86,2019,광주,질병,0,1,1
C86,2019,서울,질병,4,3,7
C86,2020,서울,질병,0,1,1
C86,2021,서울,질병,4,7,11
C86,2021,인천,질병,0,1,1
C86,2022,서울,질병,5,3,8
C86,2023,서울,질병,2,4,6
C88,2019,광주,질병,1,4,5
C88,2019,서울,질병,3,3,6
C88,2020,서울,질병,5,2,7
C88,2021,서울,질병,3,0,3
C88,2022,서울,질병,1,0,1
C88,2023,서울,질병,8,0,8
C90,2019,광주,질병,11,6,17
C90,2019,대구,질병,0,1,1
C90,2019,대전,질병,2,1,3
C90,2019,부산,질병,1,0,1
C90,2019,서울,질병,32,12,44
C90,2020,광주,질병,4,0,4
C90,2020,서울,질병,36,9,45
C90,2021,광주,질병,1,0,1
C90,2021,대전,질병,3,1,4
C90,2021,부산,질병,7,0,7
C90,2021,서울,질병,37,18,55
C90,2022,광주,질병,1,1,2
C90,2022,대구,질병,2,1,3
C90,2022,대전,질병,1,1,2
C90,2022,부산,질병,4,0,4
C90,2022,서울,질병,14,10,24
C90,2023,대구,질병,4,0,4
C90,2023,대전,질병,3,2,5
C90,2023,부산,질병,4,0,4
C90,2023,서울,질병,14,9,23
C91,2019,광주,질병,0,1,1
C91,2019,서울,질병,3,6,9
C91,2020,서울,질병,10,2,12
C91,2021,서울,질병,3,3,6
C91,2022,대전,질병,0,1,1
C91,2022,서울,질병,0,3,3
C91,2023,대전,질병,0,1,1
C91,2023,부산,질병,1,0,1
C91,2023,서울,질병,3,3,6
C92,2019,광주,질병,2,2,4
C92,2019,대구,질병,1,0,1
C92,2019,대전,질병,1,1,2
C92,2019,부산,질병,4,0,4
C92,2019,서울,질병,33,23,56
C92,2020,광주,질병,0,4,4
C92,2020,대전,질병,1,0,1
C92,2020,서울,질병,41,15,56
C92,2021,대구,질병,1,0,1
C92,2021,부산,질병,6,0,6
C92,2021,서울,질병,42,7,49
C92,2022,대구,질병,1,0,1
C92,2022,대전,질병,0,1,1
C92,2022,부산,질병,5,0,5
C92,2022,서울,질병,17,2,19
C92,2023,대구,질병,1,1,2
C92,2023,대전,질병,0,1,1
C92,2023,부산,질병,3,0,3
C92,2023,서울,질병,16,10,26
C93,2019,서울,질병,0,1,1
C93,2020,서울,질병,2,3,5
C93,2021,서울,질병,5,2,7
C93,2022,대전,질병,0,1,1
C93,2022,서울,질병,5,2,7
C93,2023,서울,질병,3,1,4
C94,2019,광주,질병,2,0,2
C95,2019,대구,질병,1,0,1
C95,2019,서울,질병,0,1,1
C95,2020,대구,질병,1,0,1
C95,2021,광주,질병,1,1,2
C95,2021,서울,질병,0,2,2
C95,2022,광주,질병,0,2,2
C95,2023,대구,질병,1,1,2
C95,2023,대전,질병,0,2,2
C95,2023,서울,질병,1,0,1
C96,2019,대전,질병,0,1,1
C96,2019,서울,질병,1,0,1
C96,2022,서울,질병,0,3,3
C96,2023,부산,질병,0,1,1
C96,2023,서울,질병,1,2,3
C97,2019,서울,질병,60,23,83
C97,2019,인천,질병,1,0,1
C97,2020,서울,질병,90,40,130
C97,2021,서울,질병,111,33,144
C97,2022,서울,질병,130,48,178
C97,2023,서울,질병,142,64,206
D00,2019,광주,질병,1,1,2
D00,2019,대전,질병,1,0,1
D00,2019,서울,질병,16,8,24
D00,2020,광주,질병,1,0,1
D00,2020,대전,질병,0,1,1
D00,2020,서울,질병,9,8,17
D00,2021,광주,질병,1,2,3
D00,2021,대전,질병,0,1,1
D00,2021,서울,질병,12,1,13
D00,2022,대구,질병,1,0,1
D00,2022,대전,질병,1,0,1
D00,2022,서울,질병,10,8,18
D00,2023,서울,질병,6,3,9
D01,2019,광주,질병,1,0,1
D01,2019,대구,질병,1,0,1
D01,2019,대전,질병,5,3,8
D01,2019,부산,질병,1,1,2
D01,2019,서울,질병,30,42,72
D01,2019,인천,질병,1,2,3
D01,2020,광주,질병,0,1,1
D01,2020,대전,질병,2,2,4
D01,2020,서울,질병,37,29,66
D01,2020,인천,질병,2,0,2
D01,2021,대구,질병,1,0,1
D01,2021,대전,질병,2,1,3
D01,2021,서울,질병,27,30,57
D01,2021,인천,질병,1,0,1
D01,2022,대전,질병,1,2,3
D01,2022,부산,질병,1,0,1
D01,2022,서울,질병,19,19,38
D01,2023,광주,질병,0,1,1
D01,2023,부산,질병,1,0,1
D01,2023,서울,질병,24,19,43
D02,2019,서울,질병,5,8,13
D02,2020,서울,질병,4,1,5
D02,2021,서울,질병,7,7,14
D02,2022,서울,질병,4,4,8
D02,2023,서울,질병,8,6,14
D03,2019,서울,질병,1,2,3
D03,2020,서울,질병,1,0,1
D03,2021,부산,질병,0,1,1
D04,2019,서울,질병,2,6,8
D04,2020,서울,질병,3,0,3
D04,2021,서울,질병,1,2,3
D04,2022,서울,질병,1,3,4
D04,2023,서울,질병,3,2,5
D05,2019,서울,질병,0,11,11
D05,2020,광주,질병,0,1,1
D05,2020,서울,질병,0,9,9
D05,2021,서울,질병,0,18,18
D05,2022,서울,질병,0,14,14
D05,2023,서울,질병,0,17,17
D06,2019,서울,질병,0,13,13
D06,2020,서울,질병,0,6,6
D06,2021,서울,질병,0,6,6
D06,2022,서울,질병,0,4,4
D06,2023,서울,질병,0,2,2
D07,2019,서울,질병,0,3,3
D07,2020,서울,질병,35,27,62
D07,2021,서울,질병,61,42,103
D07,2022,서울,질병,77,53,130
D07,2023,서울,질병,50,35,85
D09,2019,광주,질병,0,3,3
D09,2019,대구,질병,28,4,32
D09,2019,대전,질병,2,1,3
D09,2019,부산,질병,0,1,1
D09,2019,서울,질병,71,25,96
D09,2019,인천,질병,0,4,4
D09,2020,광주,질병,2,3,5
D09,2020,대구,질병,17,3,20
D09,2020,대전,질병,7,3,10
D09,2020,서울,질병,93,35,128
D09,2020,인천,질병,0,3,3
D09,2021,광주,질병,3,0,3
D09,2021,대구,질병,16,3,19
D09,2021,대전,질병,1,1,2
D09,2021,서울,질병,81,44,125
D09,2021,인천,질병,2,0,2
D09,2022,광주,질병,0,1,1
D09,2022,대구,질병,18,3,21
D09,2022,대전,질병,5,0,5
D09,2022,서울,질병,107,35,142
D09,2022,인천,질병,2,3,5
D09,2023,광주,질병,3,4,7
D09,2023,대구,질병,15,7,22
D09,2023,서울,질병,138,52,190
D09,2023,인천,질병,6,11,17
D10,2019,대전,질병,4,0,4
D10,2019,서울,질병,10,5,15
D10,2020,대구,질병,1,0,1
D10,2020,대전,질병,2,2,4
D10,2020,서울,질병,12,10,22
D10,2021,대구,질병,1,0,1
D10,2021,대전,질병,1,1,2
D10,2021,서울,질병,8,3,11
D10,2022,대전,질병,2,2,4
D10,2022,서울,질병,9,3,12
D10,2023,광주,질병,1,0,1
D10,2023,대전,질병,4,3,7
D10,2023,서울,질병,14,10,24
D11,2019,광주,질병,0,2,2
D11,2019,서울,질병,15,12,27
D11,2019,인천,질병,0,1,1
D11,2020,광주,질병,1,0,1
D11,2020,서울,질병,9,8,17
D11,2021,서울,질병,13,3,16
D11,2022,광주,질병,0,1,1
D11,2022,서울,질병,12,8,20
D11,2023,서울,질병,9,6,15
D12,2019,광주,질병,11,7,18
D12,2019,대구,질병,25,23,48
D12,2019,대전,질병,440,148,588
D12,2019,부산,질병,11,5,16
D12,2019,서울,질병,325,289,614
D12,2019,인천,질병,0,4,4
D12,2020,광주,질병,10,11,21
D12,2020,대구,질병,52,2,54
D12,2020,대전,질병,545,213,758
D12,2020,서울,질병,327,274,601
D12,2020,인천,질병,0,1,1
D12,2021,광주,질병,8,4,12
D12,2021,대구,질병,46,30,76
D12,2021,대전,질병,554,222,776
D12,2021,부산,질병,13,3,16
D12,2021,서울,질병,242,224,466
D12,2022,광주,질병,14,4,18
D12,2022,대구,질병,102,9,111
D12,2022,대전,질병,404,128,532
D12,2022,부산,질병,16,4,20
D12,2022,서울,질병,235,194,429
D12,2022,인천,질병,1,0,1
D12,2023,광주,질병,12,8,20
D12,2023,대구,질병,20,14,34
D12,2023,대전,질병,526,200,726
D12,2023,부산,질병,21,5,26
D12,2023,서울,질병,274,219,493
D12,2023,인천,질병,3,2,5
D13,2019,광주,질병,26,26,52
D13,2019,대구,질병,24,13,37
D13,2019,대전,질병,8,4,12
D13,2019,부산,질병,12,3,15
D13,2019,서울,질병,75,64,139
D13,2019,인천,질병,6,13,19
D13,2020,광주,질병,43,30,73
D13,2020,대구,질병,28,13,41
D13,2020,대전,질병,2,1,3
D13,2020,서울,질병,73,50,123
D13,2020,인천,질병,0,1,1
D13,2021,광주,질병,33,21,54
D13,2021,대구,질병,45,24,69
D13,2021,대전,질병,3,2,5
D13,2021,부산,질병,15,9,24
D13,2021,서울,질병,73,47,120
D13,2021,인천,질병,1,0,1
D13,2022,광주,질병,14,14,28
D13,2022,대구,질병,28,22,50
D13,2022,대전,질병,5,0,5
D13,2022,부산,질병,22,5,27
D13,2022,서울,질병,61,49,110
D13,2022,인천,질병,1,3,4
D13,2023,광주,질병,20,6,26
D13,2023,대구,질병,22,16,38
D13,2023,대전,질병,7,0,7
D13,2023,부산,질병,16,5,21
D13,2023,서울,질병,66,51,117
D13,2023,인천,질병,1,0,1
D14,2019,부산,질병,12,0,12
D14,2019,서울,질병,19,8,27
D14,2020,광주,질병,0,1,1
D14,2020,대전,질병,1,0,1
D14,2020,서울,질병,6,11,17
D14,2021,부산,질병,20,0,20
D14,2021,서울,질병,5,7,12
D14,2022,대전,질병,0,1,1
D14,2022,부산,질병,10,0,10
D14,2022,서울,질병,2,8,10
D14,2023,대전,질병,2,0,2
D14,2023,부산,질병,14,2,16
D14,2023,서울,질병,6,10,16
D15,2019,광주,질병,1,0,1
D15,2019,대구,질병,0,1,1
D15,2019,부산,질병,1,0,1
D15,2019,서울,질병,0,1,1
D15,2020,광주,질병,0,2,2
D15,2020,대구,질병,0,1,1
D15,2021,서울,질병,1,0,1
D15,2022,서울,질병,1,4,5
D15,2023,서울,질병,1,1,2
D16,2019,부산,질병,1,0,1
D16,2019,서울,질병,2,3,5
D16,2020,광주,질병,0,1,1
D16,2020,서울,질병,1,4,5
D16,2021,광주,질병,1,0,1
D16,2021,서울,질병,3,2,5
D16,2022,대구,질병,2,0,2
D16,2022,부산,질병,1,0,1
D16,2022,서울,질병,3,0,3
D16,2023,광주,질병,1,0,1
D16,2023,대구,질병,0,1,1
D16,2023,부산,질병,4,0,4
D16,2023,서울,질병,3,0,3
D17,2019,광주,질병,5,6,11
D17,2019,대구,질병,7,6,13
D17,2019,대전,질병,1,1,2
D17,2019,부산,질병,4,1,5
D17,2019,서울,질병,32,50,82
D17,2020,광주,질병,2,4,6
D17,2020,대구,질병,8,6,14
D17,2020,대전,질병,2,2,4
D17,2020,서울,질병,27,31,58
D17,2020,인천,질병,2,1,3
D17,2021,광주,질병,1,2,3
D17,2021,대구,질병,6,6,12
D17,2021,대전,질병,5,2,7
D17,2021,부산,질병,4,2,6
D17,2021,서울,질병,18,31,49
D17,2021,인천,질병,4,9,13
D17,2022,광주,질병,1,5,6
D17,2022,대구,질병,5,1,6
D17,2022,대전,질병,2,2,4
D17,2022,부산,질병,3,2,5
D17,2022,서울,질병,18,19,37
D17,2022,인천,질병,1,7,8
D17,2023,광주,질병,4,0,4
D17,2023,대구,질병,3,1,4
D17,2023,대전,질병,2,0,2
D17,2023,부산,질병,4,4,8
D17,2023,서울,질병,22,31,53
D17,2023,인천,질병,0,1,1
D18,2019,광주,질병,1,2,3
D18,2019,대구,질병,3,1,4
D18,2019,대전,질병,4,0,4
D18,2019,부산,질병,3,1,4
D18,2019,서울,질병,7,11,18
D18,2020,광주,질병,0,2,2
D18,2020,대구,질병,6,2,8
D18,2020,서울,질병,12,13,25
D18,2021,광주,질병,0,1,1
D18,2021,대구,질병,3,1,4
D18,2021,대전,질병,2,0,2
D18,2021,부산,질병,3,2,5
D18,2021,서울,질병,8,3,11
D18,2022,대전,질병,0,1,1
D18,2022,부산,질병,2,0,2
D18,2022,서울,질병,5,2,7
D18,2022,인천,질병,0,1,1
D18,2023,광주,질병,1,0,1
D18,2023,부산,질병,3,1,4
D18,2023,서울,질병,11,7,18
D20,2019,서울,질병,2,0,2
D20,2020,광주,질병,0,1,1
D20,2020,서울,질병,2,0,2
D20,2021,광주,질병,2,0,2
D21,2019,광주,질병,0,3,3
D21,2019,대구,질병,0,2,2
D21,2019,대전,질병,1,0,1
D21,2019,서울,질병,1,7,8
D21,2020,광주,질병,0,2,2
D21,2020,대구,질병,0,1,1
D21,2020,대전,질병,1,0,1
D21,2020,서울,질병,0,5,5
D21,2021,광주,질병,4,0,4
D21,2021,대전,질병,1,0,1
D21,2021,부산,질병,1,0,1
D21,2021,서울,질병,4,5,9
D21,2021,인천,질병,1,1,2
D21,2022,광주,질병,4,3,7
D21,2022,대구,질병,1,0,1
D21,2022,부산,질병,1,0,1
D21,2022,서울,질병,2,2,4
D21,2023,광주,질병,2,4,6
D21,2023,대구,질병,1,3,4
D21,2023,서울,질병,2,4,6
D21,2023,인천,질병,1,1,2
D22,2019,서울,질병,3,3,6
D22,2020,서울,질병,0,1,1
D22,2020,인천,질병,0,1,1
D22,2021,서울,질병,2,2,4
D22,2022,서울,질병,1,0,1
D22,2023,서울,질병,3,4,7
D23,2019,대구,질병,4,0,4
D23,2019,대전,질병,1,0,1
D23,2019,서울,질병,2,1,3
D23,2020,대구,질병,1,0,1
D23,2020,서울,질병,4,0,4
D23,2020,인천,질병,1,0,1
D23,2021,광주,질병,0,1,1
D23,2021,대구,질병,0,2,2
D23,2021,대전,질병,1,1,2
D23,2021,부산,질병,0,1,1
D23,2021,서울,질병,1,0,1
D23,2022,대구,질병,2,1,3
D23,2022,서울,질병,5,1,6
D23,2023,광주,질병,0,1,1
D23,2023,대구,질병,1,0,1
D23,2023,대전,질병,0,1,1
D23,2023,서울,질병,0,7,7
D24,2019,광주,질병,0,3,3
D24,2019,대전,질병,0,1,1
D24,2019,서울,질병,0,13,13
D24,2020,서울,질병,0,14,14
D24,2021,광주,질병,0,2,2
D24,2021,서울,질병,1,27,28
D24,2022,서울,질병,0,10,10
D24,2023,광주,질병,0,1,1
D24,2023,서울,질병,0,7,7
D25,2019,서울,질병,0,61,61
D25,2020,서울,질병,3,84,87
D25,2021,서울,질병,0,49,49
D25,2022,서울,질병,3,42,45
D25,2023,서울,질병,2,57,59
D26,2019,광주,질병,0,1,1
D26,2019,서울,질병,0,2,2
D26,2020,서울,질병,1,1,2
D26,2022,서울,질병,0,1,1
D26,2023,서울,질병,0,2,2
D27,2019,서울,질병,0,8,8
D27,2020,서울,질병,0,23,23
D27,2021,서울,질병,1,20,21
D27,2022,서울,질병,3,12,15
D27,2023,서울,질병,0,35,35
D28,2020,서울,질병,0,1,1
D29,2019,서울,질병,1,1,2
D29,2020,대구,질병,0,2,2
D29,2023,서울,질병,0,2,2
D30,2019,광주,질병,0,1,1
D30,2019,대구,질병,1,0,1
D30,2019,부산,질병,3,0,3
D30,2019,서울,질병,1,3,4
D30,2020,광주,질병,1,0,1
D30,2020,서울,질병,4,3,7
D30,2021,광주,질병,2,2,4
D30,2021,대전,질병,1,0,1
D30,2021,부산,질병,2,2,4
D30,2021,서울,질병,6,4,10
D30,2022,광주,질병,0,1,1
D30,2022,부산,질병,3,0,3
D30,2022,서울,질병,7,1,8
D30,2022,인천,질병,0,1,1
D30,2023,광주,질병,1,1,2
D30,2023,대구,질병,1,0,1
D30,2023,부산,질병,2,1,3
D30,2023,서울,질병,6,4,10
D31,2019,대구,질병,1,0,1
D31,2019,서울,질병,0,1,1
D31,2020,서울,질병,1,0,1
D31,2021,광주,질병,1,0,1
D31,2021,인천,질병,0,1,1
D31,2023,부산,질병,1,0,1
D32,2019,광주,질병,0,3,3
D32,2019,부산,질병,2,0,2
D32,2019,서울,질병,7,17,24
D32,2020,광주,질병,3,1,4
D32,2020,대구,질병,1,0,1
D32,2020,대전,질병,0,2,2
D32,2020,서울,질병,12,7,19
D32,2021,광주,질병,4,0,4
D32,2021,대구,질병,0,1,1
D32,2021,부산,질병,0,3,3
D32,2021,서울,질병,5,1,6
D32,2022,광주,질병,1,3,4
D32,2022,부산,질병,4,0,4
D32,2022,서울,질병,3,4,7
D32,2022,인천,질병,1,0,1
D32,2023,광주,질병,0,3,3
D32,2023,대전,질병,6,1,7
D32,2023,부산,질병,3,0,3
D32,2023,서울,질병,7,3,10
D33,2019,대구,질병,0,1,1
D33,2019,대전,질병,2,0,2
D33,2019,부산,질병,1,0,1
D33,2019,서울,질병,5,4,9
D33,2020,광주,질병,2,0,2
D33,2020,대전,질병,1,0,1
D33,2020,서울,질병,3,2,5
D33,2021,부산,질병,1,0,1
D33,2021,서울,질병,1,4,5
D33,2022,서울,질병,2,2,4
D33,2022,인천,질병,0,1,1
D33,2023,부산,질병,2,1,3
D33,2023,서울,질병,6,3,9
D34,2019,대전,질병,1,0,1
D34,2019,부산,질병,0,2,2
D34,2019,서울,질병,2,12,14
D34,2020,광주,질병,1,0,1
D34,2020,대전,질병,2,0,2
D34,2020,서울,질병,6,9,15
D34,2021,광주,질병,1,0,1
D34,2021,부산,질병,0,1,1
D34,2021,서울,질병,4,1,5
D34,2022,광주,질병,2,1,3
D34,2022,서울,질병,2,6,8
D34,2023,광주,질병,0,1,1
D34,2023,서울,질병,4,3,7
D35,2019,광주,질병,1,0,1
D35,2019,대구,질병,8,0,8
D35,2019,대전,질병,3,0,3
D35,2019,부산,질병,14,0,14
D35,2019,서울,질병,12,12,24
D35,2020,광주,질병,4,3,7
D35,2020,대구,질병,1,0,1
D35,2020,대전,질병,1,0,1
D35,2020,서울,질병,30,19,49
D35,2021,광주,질병,2,0,2
D35,2021,대구,질병,2,0,2
D35,2021,부산,질병,12,1,13
D35,2021,서울,질병,17,21,38
D35,2022,광주,질병,0,1,1
D35,2022,대구,질병,2,0,2
D35,2022,대전,질병,1,0,1
D35,2022,부산,질병,5,0,5
D35,2022,서울,질병,17,18,35
D35,2022,인천,질병,0,1,1
D35,2023,광주,질병,10,9,19
D35,2023,부산,질병,3,0,3
D35,2023,서울,질병,12,21,33
D36,2019,광주,질병,1,1,2
D36,2019,대구,질병,0,2,2
D36,2019,대전,질병,1,0,1
D36,2019,부산,질병,2,0,2
D36,2019,서울,질병,8,4,12
D36,2019,인천,질병,0,1,1
D36,2020,광주,질병,3,0,3
D36,2020,대구,질병,1,0,1
D36,2020,서울,질병,10,7,17
D36,2020,인천,질병,0,1,1
D36,2021,광주,질병,1,0,1
D36,2021,대구,질병,3,0,3
D36,2021,부산,질병,5,0,5
D36,2021,서울,질병,4,2,6
D36,2022,광주,질병,0,1,1
D36,2022,부산,질병,4,0,4
D36,2022,서울,질병,2,3,5
D36,2022,인천,질병,0,1,1
D36,2023,대구,질병,1,0,1
D36,2023,부산,질병,2,0,2
D36,2023,서울,질병,8,2,10
D37,2019,광주,질병,7,3,10
D37,2019,대구,질병,2,1,3
D37,2019,대전,질병,5,1,6
D37,2019,부산,질병,11,1,12
D37,2019,서울,질병,14,11,25
D37,2020,광주,질병,8,4,12
D37,2020,대구,질병,5,3,8
D37,2020,서울,질병,10,13,23
D37,2021,광주,질병,7,3,10
D37,2021,대구,질병,2,1,3
D37,2021,대전,질병,4,1,5
D37,2021,부산,질병,11,1,12
D37,2021,서울,질병,6,13,19
D37,2021,인천,질병,1,1,2
D37,2022,광주,질병,3,4,7
D37,2022,대구,질병,2,1,3
D37,2022,대전,질병,2,0,2
D37,2022,부산,질병,6,1,7
D37,2022,서울,질병,5,7,12
D37,2023,광주,질병,3,3,6
D37,2023,대구,질병,1,0,1
D37,2023,대전,질병,7,2,9
D37,2023,부산,질병,17,1,18
D37,2023,서울,질병,7,10,17
D38,2019,광주,질병,0,1,1
D38,2019,대구,질병,1,3,4
D38,2019,부산,질병,2,0,2
D38,2019,서울,질병,3,2,5
D38,2020,대구,질병,4,1,5
D38,2020,대전,질병,0,1,1
D38,2020,서울,질병,6,3,9
D38,2021,부산,질병,1,2,3
D38,2021,서울,질병,2,2,4
D38,2022,부산,질병,0,1,1
D38,2022,서울,질병,2,0,2
D38,2023,부산,질병,2,0,2
D38,2023,서울,질병,3,2,5
D39,2019,서울,질병,0,4,4
D39,2020,서울,질병,0,5,5
D39,2021,서울,질병,0,4,4
D39,2022,대구,질병,1,0,1
D39,2022,서울,질병,0,1,1
D39,2023,서울,질병,0,1,1
D40,2019,광주,질병,3,0,3
D40,2019,대구,질병,1,0,1
D40,2020,서울,질병,1,0,1
D41,2019,대구,질병,3,2,5
D41,2019,대전,질병,0,1,1
D41,2019,부산,질병,5,0,5
D41,2019,서울,질병,3,2,5
D41,2019,인천,질병,4,17,21
D41,2020,대구,질병,3,1,4
D41,2020,서울,질병,5,2,7
D41,2020,인천,질병,10,14,24
D41,2021,대구,질병,3,1,4
D41,2021,대전,질병,0,1,1
D41,2021,부산,질병,10,0,10
D41,2021,서울,질병,6,9,15
D41,2021,인천,질병,9,10,19
D41,2022,대구,질병,2,0,2
D41,2022,대전,질병,1,1,2
D41,2022,부산,질병,4,1,5
D41,2022,서울,질병,5,4,9
D41,2022,인천,질병,2,1,3
D41,2023,대구,질병,2,0,2
D41,2023,대전,질병,3,1,4
D41,2023,부산,질병,1,4,5
D41,2023,서울,질병,3,2,5
D41,2023,인천,질병,1,0,1
D42,2019,서울,질병,0,3,3
D42,2020,대구,질병,1,0,1
D42,2020,대전,질병,0,1,1
D42,2020,서울,질병,0,1,1
D42,2021,대전,질병,0,1,1
D42,2021,서울,질병,0,3,3
D42,2021,인천,질병,0,1,1
D42,2023,대구,질병,0,1,1
D42,2023,서울,질병,1,0,1
D43,2019,광주,질병,0,1,1
D43,2019,대구,질병,0,5,5
D43,2019,대전,질병,0,1,1
D43,2019,서울,질병,2,3,5
D43,2020,광주,질병,1,0,1
D43,2020,대전,질병,1,1,2
D43,2020,서울,질병,1,3,4
D43,2021,광주,질병,0,2,2
D43,2021,부산,질병,1,0,1
D43,2021,서울,질병,3,1,4
D43,2022,광주,질병,0,2,2
D43,2022,대전,질병,1,0,1
D43,2022,부산,질병,1,0,1
D43,2022,서울,질병,0,3,3
D43,2023,광주,질병,0,2,2
D43,2023,대구,질병,1,0,1
D43,2023,대전,질병,0,5,5
D43,2023,부산,질병,0,1,1
D43,2023,서울,질병,1,2,3
D43,2023,인천,질병,1,0,1
D44,2019,광주,질병,0,1,1
D44,2019,부산,질병,1,0,1
D44,2019,서울,질병,2,3,5
D44,2020,서울,질병,3,1,4
D44,2021,서울,질병,0,3,3
D44,2022,서울,질병,2,1,3
D44,2023,대구,질병,0,1,1
D44,2023,부산,질병,1,0,1
D44,2023,서울,질병,0,2,2
D45,2019,서울,질병,4,0,4
D45,2020,광주,질병,1,2,3
D45,2020,서울,질병,6,2,8
D45,2021,부산,질병,2,3,5
D45,2021,서울,질병,5,1,6
D45,2022,서울,질병,3,0,3
D45,2023,서울,질병,8,2,10
D46,2019,광주,질병,28,19,47
D46,2019,대전,질병,0,3,3
D46,2019,서울,질병,49,18,67
D46,2020,광주,질병,5,2,7
D46,2020,대구,질병,2,0,2
D46,2020,대전,질병,1,3,4
D46,2020,서울,질병,70,12,82
D46,2021,광주,질병,1,3,4
D46,2021,대구,질병,1,1,2
D46,2021,대전,질병,1,1,2
D46,2021,부산,질병,2,0,2
D46,2021,서울,질병,40,11,51
D46,2022,광주,질병,0,1,1
D46,2022,대구,질병,2,0,2
D46,2022,서울,질병,14,4,18
D46,2023,광주,질병,2,0,2
D46,2023,대구,질병,0,1,1
D46,2023,대전,질병,1,0,1
D46,2023,부산,질병,1,0,1
D46,2023,서울,질병,26,10,36
D47,2019,광주,질병,14,5,19
D47,2019,대전,질병,0,1,1
D47,2019,서울,질병,16,9,25
D47,2020,광주,질병,6,3,9
D47,2020,서울,질병,12,8,20
D47,2021,광주,질병,5,2,7
D47,2021,대구,질병,2,0,2
D47,2021,부산,질병,5,1,6
D47,2021,서울,질병,23,4,27
D47,2022,광주,질병,5,2,7
D47,2022,대구,질병,1,0,1
D47,2022,대전,질병,1,2,3
D47,2022,서울,질병,12,7,19
D47,2023,광주,질병,9,0,9
D47,2023,대구,질병,0,1,1
D47,2023,부산,질병,1,0,1
D47,2023,서울,질병,17,16,33
D48,2019,광주,질병,1,2,3
D48,2019,대구,질병,1,1,2
D48,2019,부산,질병,3,2,5
D48,2019,서울,질병,3,6,9
D48,2019,인천,질병,0,1,1
D48,2020,대구,질병,4,0,4
D48,2020,대전,질병,2,0,2
D48,2020,서울,질병,3,9,12
D48,2021,광주,질병,2,1,3
D48,2021,대구,질병,1,0,1
D48,2021,대전,질병,0,1,1
D48,2021,부산,질병,7,0,7
D48,2021,서울,질병,3,0,3
D48,2022,대구,질병,2,0,2
D48,2022,부산,질병,2,2,4
D48,2022,서울,질병,4,2,6
D48,2023,광주,질병,1,0,1
D48,2023,대구,질병,1,1,2
D48,2023,부산,질병,8,0,8
D48,2023,서울,질병,1,3,4
D50,2019,광주,질병,9,5,14
D50,2019,대구,질병,44,19,63
D50,2019,대전,질병,23,24,47
D50,2019,부산,질병,10,4,14
D50,2019,서울,질병,59,58,117
D50,2020,광주,질병,6,2,8
D50,2020,대구,질병,28,13,41
D50,2020,대전,질병,35,22,57
D50,2020,서울,질병,70,58,128
D50,2021,광주,질병,1,5,6
D50,2021,대구,질병,26,14,40
D50,2021,대전,질병,18,14,32
D50,2021,부산,질병,7,0,7
D50,2021,서울,질병,58,39,97
D50,2022,광주,질병,1,4,5
D50,2022,대구,질병,16,9,25
D50,2022,대전,질병,13,10,23
D50,2022,부산,질병,11,3,14
D50,2022,서울,질병,82,63,145
D50,2023,광주,질병,2,10,12
D50,2023,대구,질병,11,6,17
D50,2023,대전,질병,10,9,19
D50,2023,부산,질병,2,1,3
D50,2023,서울,질병,132,102,234
D51,2019,대구,질병,4,0,4
D51,2019,서울,질병,4,5,9
D51,2020,서울,질병,4,0,4
D51,2021,대구,질병,0,1,1
D51,2021,부산,질병,0,1,1
D51,2021,서울,질병,5,1,6
D51,2022,서울,질병,5,1,6
D51,2023,서울,질병,4,1,5
D52,2019,서울,질병,0,2,2
D52,2020,대구,질병,0,3,3
D52,2020,서울,질병,12,8,20
D52,2021,대구,질병,1,0,1
D52,2021,서울,질병,7,4,11
D52,2022,대구,질병,1,0,1
D52,2022,대전,질병,1,0,1
D52,2022,서울,질병,4,7,11
D52,2023,대전,질병,2,0,2
D52,2023,서울,질병,3,4,7
D53,2019,광주,질병,1,1,2
D53,2019,대구,질병,0,1,1
D53,2019,서울,질병,1,0,1
D53,2020,광주,질병,1,0,1
D53,2020,서울,질병,0,1,1
D53,2021,서울,질병,4,0,4
D53,2022,대전,질병,0,2,2
D53,2022,서울,질병,1,6,7
D53,2023,광주,질병,1,0,1
D53,2023,대전,질병,0,1,1
D53,2023,서울,질병,7,2,9
D58,2023,서울,질병,0,1,1
D59,2019,광주,질병,1,1,2
D59,2019,대구,질병,1,0,1
D59,2019,서울,질병,0,2,2
D59,2020,광주,질병,0,1,1
D59,2020,서울,질병,0,4,4
D59,2021,대구,질병,1,0,1
D59,2021,인천,질병,4,0,4
D59,2022,서울,질병,1,3,4
D59,2023,대전,질병,0,2,2
D59,2023,서울,질병,2,1,3
D60,2020,서울,질병,3,0,3
D60,2022,서울,질병,0,1,1
D61,2019,광주,질병,0,3,3
D61,2019,대전,질병,2,0,2
D61,2019,부산,질병,1,2,3
D61,2019,서울,질병,18,19,37
D61,2020,광주,질병,2,2,4
D61,2020,대전,질병,1,0,1
D61,2020,서울,질병,11,18,29
D61,2020,인천,질병,0,1,1
D61,2021,대구,질병,0,4,4
D61,2021,부산,질병,2,0,2
D61,2021,서울,질병,11,17,28
D61,2022,대전,질병,0,1,1
D61,2022,부산,질병,2,0,2
D61,2022,서울,질병,8,23,31
D61,2023,대구,질병,1,0,1
D61,2023,대전,질병,1,0,1
D61,2023,서울,질병,14,6,20
D62,2019,대구,질병,0,1,1
D62,2019,서울,질병,5,1,6
D62,2020,대구,질병,1,1,2
D62,2020,서울,질병,28,22,50
D62,2021,서울,질병,18,27,45
D62,2022,서울,질병,10,8,18
D62,2023,대구,질병,1,0,1
D62,2023,서울,질병,9,10,19
D63,2019,광주,질병,1,0,1
D63,2019,대구,질병,6,0,6
D63,2019,대전,질병,3,0,3
D63,2019,서울,질병,39,23,62
D63,2020,광주,질병,0,2,2
D63,2020,대전,질병,1,1,2
D63,2020,서울,질병,71,77,148
D63,2021,서울,질병,83,48,131
D63,2022,서울,질병,79,53,132
D63,2023,대구,질병,0,1,1
D63,2023,부산,질병,1,0,1
D63,2023,서울,질병,110,70,180
D64,2019,광주,질병,7,8,15
D64,2019,대구,질병,14,15,29
D64,2019,대전,질병,15,11,26
D64,2019,부산,질병,10,3,13
D64,2019,서울,질병,50,51,101
D64,2019,인천,질병,2,0,2
D64,2020,광주,질병,14,19,33
D64,2020,대구,질병,13,17,30
D64,2020,대전,질병,20,17,37
D64,2020,서울,질병,71,81,152
D64,2021,광주,질병,2,11,13
D64,2021,대구,질병,13,11,24
D64,2021,대전,질병,21,15,36
D64,2021,부산,질병,16,8,24
D64,2021,서울,질병,52,70,122
D64,2021,인천,질병,1,1,2
D64,2022,광주,질병,4,1,5
D64,2022,대구,질병,28,12,40
D64,2022,대전,질병,19,15,34
D64,2022,부산,질병,12,11,23
D64,2022,서울,질병,68,68,136
D64,2023,광주,질병,8,14,22
D64,2023,대구,질병,20,9,29
D64,2023,대전,질병,17,10,27
D64,2023,부산,질병,12,9,21
D64,2023,서울,질병,40,42,82
D65,2019,대구,질병,0,1,1
D65,2020,대구,질병,0,1,1
D65,2020,서울,질병,2,3,5
D65,2021,대구,질병,0,1,1
D65,2021,서울,질병,2,5,7
D65,2022,대구,질병,2,0,2
D65,2022,대전,질병,0,1,1
D65,2022,서울,질병,8,3,11
D65,2023,대구,질병,1,1,2
D65,2023,서울,질병,6,1,7
D68,2019,대전,질병,1,0,1
D68,2019,부산,질병,1,0,1
D68,2019,서울,질병,8,3,11
D68,2020,서울,질병,3,6,9
D68,2021,광주,질병,1,0,1
D68,2021,부산,질병,1,0,1
D68,2021,서울,질병,2,4,6
D68,2022,부산,질병,1,0,1
D68,2022,서울,질병,4,2,6
D68,2023,서울,질병,4,2,6
D69,2019,광주,질병,1,2,3
D69,2019,대구,질병,4,3,7
D69,2019,대전,질병,0,3,3
D69,2019,부산,질병,3,0,3
D69,2019,서울,질병,45,26,71
D69,2020,광주,질병,2,2,4
D69,2020,대구,질병,5,1,6
D69,2020,대전,질병,1,1,2
D69,2020,서울,질병,44,31,75
D69,2021,광주,질병,1,0,1
D69,2021,대구,질병,3,3,6
D69,2021,대전,질병,0,1,1
D69,2021,부산,질병,1,0,1
D69,2021,서울,질병,29,37,66
D69,2022,대구,질병,3,2,5
D69,2022,대전,질병,0,2,2
D69,2022,서울,질병,35,36,71
D69,2023,광주,질병,1,0,1
D69,2023,대구,질병,1,0,1
D69,2023,대전,질병,2,2,4
D69,2023,부산,질병,1,0,1
D69,2023,서울,질병,54,23,77
D70,2019,광주,질병,1,0,1
D70,2019,대전,질병,0,1,1
D70,2019,서울,질병,104,55,159
D70,2020,대구,질병,1,1,2
D70,2020,대전,질병,1,0,1
D70,2020,서울,질병,73,38,111
D70,2021,대구,질병,1,4,5
D70,2021,서울,질병,50,27,77
D70,2022,대구,질병,1,0,1
D70,2022,서울,질병,36,29,65
D70,2023,대구,질병,1,0,1
D70,2023,대전,질병,4,0,4
D70,2023,서울,질병,68,21,89
D71,2023,부산,질병,1,0,1
D72,2019,광주,질병,7,6,13
D72,2019,서울,질병,6,3,9
D72,2020,광주,질병,14,9,23
D72,2020,서울,질병,8,14,22
D72,2021,광주,질병,2,0,2
D72,2021,부산,질병,1,0,1
D72,2021,서울,질병,11,17,28
D72,2022,대구,질병,2,0,2
D72,2022,부산,질병,1,0,1
D72,2022,서울,질병,21,8,29
D72,2023,광주,질병,1,0,1
D72,2023,대전,질병,0,1,1
D72,2023,서울,질병,14,15,29
D73,2019,광주,질병,0,1,1
D73,2019,서울,질병,1,1,2
D73,2020,대전,질병,1,0,1
D73,2020,서울,질병,2,2,4
D73,2021,광주,질병,0,1,1
D73,2021,서울,질병,4,3,7
D73,2022,서울,질병,2,4,6
D73,2023,대구,질병,0,1,1
D73,2023,서울,질병,1,1,2
D75,2019,서울,질병,0,1,1
D75,2020,광주,질병,2,2,4
D75,2020,서울,질병,1,0,1
D75,2021,광주,질병,30,13,43
D75,2022,광주,질병,41,14,55
D75,2023,광주,질병,21,8,29
D75,2023,서울,질병,0,1,1
D76,2020,서울,질병,0,1,1
D76,2021,광주,질병,0,1,1
D76,2022,서울,질병,0,2,2
D76,2023,서울,질병,0,1,1
D86,2019,광주,질병,1,1,2
D86,2020,광주,질병,0,1,1
D86,2020,서울,질병,4,1,5
D86,2021,광주,질병,1,0,1
D86,2022,서울,질병,0,1,1
D86,2023,서울,질병,2,0,2
D89,2019,광주,질병,0,1,1
D89,2019,서울,질병,3,2,5
D89,2020,서울,질병,5,3,8
D89,2021,서울,질병,1,7,8
D89,2022,서울,질병,2,2,4
D89,2023,서울,질병,5,2,7
E02,2019,서울,질병,7,8,15
E02,2020,서울,질병,11,8,19
E02,2021,서울,질병,4,3,7
E02,2023,서울,질병,0,2,2
E03,2019,광주,질병,0,2,2
E03,2019,대구,질병,19,7,26
E03,2019,대전,질병,8,1,9
E03,2019,부산,질병,6,0,6
E03,2019,서울,질병,67,57,124
E03,2019,인천,질병,0,2,2
E03,2020,대구,질병,22,11,33
E03,2020,대전,질병,11,4,15
E03,2020,서울,질병,87,84,171
E03,2021,대구,질병,15,7,22
E03,2021,대전,질병,11,1,12
E03,2021,부산,질병,6,0,6
E03,2021,서울,질병,78,72,150
E03,2021,인천,질병,1,0,1
E03,2022,광주,질병,1,0,1
E03,2022,대구,질병,8,2,10
E03,2022,대전,질병,5,1,6
E03,2022,부산,질병,0,1,1
E03,2022,서울,질병,69,41,110
E03,2023,광주,질병,1,1,2
E03,2023,대구,질병,7,3,10
E03,2023,대전,질병,2,0,2
E03,2023,부산,질병,0,1,1
E03,2023,서울,질병,88,64,152
E03,2023,인천,질병,0,1,1
E04,2019,광주,질병,0,2,2
E04,2019,대구,질병,2,2,4
E04,2019,대전,질병,4,0,4
E04,2019,부산,질병,1,0,1
E04,2019,서울,질병,42,49,91
E04,2020,광주,질병,1,0,1
E04,2020,대구,질병,11,2,13
E04,2020,대전,질병,1,0,1
E04,2020,서울,질병,43,59,102
E04,2021,광주,질병,0,1,1
E04,2021,대구,질병,3,0,3
E04,2021,대전,질병,1,2,3
E04,2021,부산,질병,0,1,1
E04,2021,서울,질병,29,25,54
E04,2022,광주,질병,1,0,1
E04,2022,대구,질병,2,0,2
E04,2022,대전,질병,1,0,1
E04,2022,서울,질병,5,12,17
E04,2023,광주,질병,3,1,4
E04,2023,대구,질병,1,1,2
E04,2023,대전,질병,1,1,2
E04,2023,서울,질병,18,13,31
E05,2019,광주,질병,1,0,1
E05,2019,대구,질병,0,1,1
E05,2019,대전,질병,2,0,2
E05,2019,서울,질병,3,18,21
E05,2019,인천,질병,1,0,1
E05,2020,대구,질병,1,4,5
E05,2020,서울,질병,9,18,27
E05,2020,인천,질병,0,1,1
E05,2021,광주,질병,1,2,3
E05,2021,대구,질병,2,0,2
E05,2021,서울,질병,7,14,21
E05,2022,광주,질병,1,0,1
E05,2022,대구,질병,2,1,3
E05,2022,서울,질병,3,10,13
E05,2023,광주,질병,0,1,1
E05,2023,대구,질병,1,0,1
E05,2023,서울,질병,5,14,19
E05,2023,인천,질병,1,0,1
E06,2019,광주,질병,0,1,1
E06,2019,대구,질병,0,1,1
E06,2019,서울,질병,3,7,10
E06,2020,광주,질병,1,0,1
E06,2020,서울,질병,2,5,7
E06,2020,인천,질병,1,0,1
E06,2021,서울,질병,3,6,9
E06,2022,광주,질병,0,1,1
E06,2022,서울,질병,6,10,16
E06,2023,서울,질병,8,3,11
E07,2019,대구,질병,5,1,6
E07,2019,대전,질병,2,1,3
E07,2019,서울,질병,1,2,3
E07,2020,대구,질병,1,1,2
E07,2020,대전,질병,5,0,5
E07,2020,서울,질병,1,0,1
E07,2021,대전,질병,3,0,3
E07,2021,서울,질병,2,0,2
E07,2022,광주,질병,1,1,2
E07,2022,서울,질병,0,2,2
E07,2023,대전,질병,0,1,1
E07,2023,서울,질병,1,1,2
E10,2019,광주,질병,3,6,9
E10,2019,대구,질병,24,15,39
E10,2019,대전,질병,22,8,30
E10,2019,부산,질병,16,6,22
E10,2019,서울,질병,10,5,15
E10,2019,인천,질병,2,0,2
E10,2020,광주,질병,14,3,17
E10,2020,대구,질병,29,1,30
E10,2020,대전,질병,9,6,15
E10,2020,서울,질병,5,6,11
E10,2020,인천,질병,1,1,2
E10,2021,광주,질병,4,9,13
E10,2021,대구,질병,7,4,11
E10,2021,대전,질병,22,4,26
E10,2021,부산,질병,4,4,8
E10,2021,서울,질병,3,5,8
E10,2021,인천,질병,1,1,2
E10,2022,광주,질병,7,3,10
E10,2022,대구,질병,6,0,6
E10,2022,대전,질병,17,5,22
E10,2022,부산,질병,3,0,3
E10,2022,서울,질병,3,4,7
E10,2022,인천,질병,3,1,4
E10,2023,광주,질병,6,4,10
E10,2023,대구,질병,0,5,5
E10,2023,대전,질병,5,1,6
E10,2023,부산,질병,11,1,12
E10,2023,서울,질병,22,7,29
E10,2023,인천,질병,1,3,4
E11,2019,광주,질병,115,58,173
E11,2019,대구,질병,421,160,581
E11,2019,대전,질병,418,144,562
E11,2019,부산,질병,175,29,204
E11,2019,서울,질병,4186,2620,6806
E11,2019,인천,질병,46,65,111
E11,2020,광주,질병,91,36,127
E11,2020,대구,질병,346,143,489
E11,2020,대전,질병,402,131,533
E11,2020,서울,질병,4135,2467,6602
E11,2020,인천,질병,87,86,173
E11,2021,광주,질병,69,28,97
E11,2021,대구,질병,351,117,468
E11,2021,대전,질병,463,138,601
E11,2021,부산,질병,127,15,142
E11,2021,서울,질병,3496,2400,5896
E11,2021,인천,질병,76,108,184
E11,2022,광주,질병,47,16,63
E11,2022,대구,질병,340,95,435
E11,2022,대전,질병,746,334,1080
E11,2022,부산,질병,81,7,88
E11,2022,서울,질병,3628,2208,5836
E11,2022,인천,질병,31,25,56
E11,2023,광주,질병,89,31,120
E11,2023,대구,질병,316,130,446
E11,2023,대전,질병,541,216,757
E11,2023,부산,질병,60,9,69
E11,2023,서울,질병,4618,668,5286
E11,2023,인천,질병,31,41,72
E12,2019,대구,질병,0,1,1
E12,2020,서울,질병,1,0,1
E12,2021,인천,질병,0,1,1
E12,2022,대전,질병,3,0,3
E12,2023,대구,질병,0,1,1
E12,2023,서울,질병,1,0,1
E13,2019,광주,질병,1,0,1
E13,2019,대구,질병,1,0,1
E13,2019,대전,질병,5,1,6
E13,2019,부산,질병,1,1,2
E13,2019,서울,질병,6,1,7
E13,2020,광주,질병,0,1,1
E13,2020,대전,질병,7,0,7
E13,2020,서울,질병,2,1,3
E13,2021,광주,질병,2,0,2
E13,2021,대전,질병,4,1,5
E13,2021,부산,질병,3,0,3
E13,2021,서울,질병,3,5,8
E13,2022,대전,질병,1,0,1
E13,2022,부산,질병,2,1,3
E13,2022,서울,질병,1,3,4
E13,2023,대전,질병,0,1,1
E13,2023,부산,질병,2,0,2
E13,2023,서울,질병,2,2,4
E14,2019,광주,질병,7,9,16
E14,2019,대구,질병,22,5,27
E14,2019,대전,질병,15,5,20
E14,2019,부산,질병,42,2,44
E14,2019,서울,질병,34,12,46
E14,2019,인천,질병,2,3,5
E14,2020,광주,질병,4,0,4
E14,2020,대구,질병,9,5,14
E14,2020,대전,질병,19,6,25
E14,2020,서울,질병,17,8,25
E14,2020,인천,질병,2,1,3
E14,2021,광주,질병,4,4,8
E14,2021,대구,질병,5,4,9
E14,2021,대전,질병,27,7,34
E14,2021,부산,질병,32,4,36
E14,2021,서울,질병,10,11,21
E14,2021,인천,질병,0,3,3
E14,2022,광주,질병,2,1,3
E14,2022,대구,질병,9,5,14
E14,2022,대전,질병,18,7,25
E14,2022,부산,질병,30,2,32
E14,2022,서울,질병,8,1,9
E14,2022,인천,질병,3,6,9
E14,2023,광주,질병,7,3,10
E14,2023,대구,질병,2,1,3
E14,2023,대전,질병,5,1,6
E14,2023,부산,질병,18,3,21
E14,2023,서울,질병,6,5,11
E14,2023,인천,질병,4,2,6
E15,2019,광주,질병,0,1,1
E15,2022,광주,질병,0,1,1
E16,2019,광주,질병,0,1,1
E16,2019,대구,질병,3,3,6
E16,2019,대전,질병,2,0,2
E16,2019,서울,질병,5,4,9
E16,2020,광주,질병,0,1,1
E16,2020,대구,질병,4,4,8
E16,2020,대전,질병,1,0,1
E16,2020,서울,질병,7,6,13
E16,2021,광주,질병,1,0,1
E16,2021,대구,질병,5,1,6
E16,2021,대전,질병,3,1,4
E16,2021,서울,질병,2,5,7
E16,2022,대구,질병,1,0,1
E16,2022,대전,질병,4,2,6
E16,2022,서울,질병,8,4,12
E16,2023,대구,질병,3,1,4
E16,2023,대전,질병,4,0,4
E16,2023,서울,질병,12,7,19
E20,2019,대구,질병,0,3,3
E20,2019,대전,질병,1,0,1
E20,2019,서울,질병,3,1,4
E20,2020,대구,질병,1,5,6
E20,2020,대전,질병,1,0,1
E20,2021,대구,질병,2,0,2
E20,2021,대전,질병,1,0,1
E20,2022,대구,질병,4,0,4
E20,2022,서울,질병,0,2,2
E20,2023,서울,질병,2,0,2
E21,2019,대전,질병,1,0,1
E21,2019,서울,질병,3,5,8
E21,2020,서울,질병,2,4,6
E21,2021,서울,질병,1,1,2
E21,2022,서울,질병,4,1,5
E21,2023,대구,질병,1,0,1
E21,2023,서울,질병,2,1,3
E22,2019,광주,질병,0,1,1
E22,2019,대전,질병,1,0,1
E22,2019,부산,질병,0,2,2
E22,2019,서울,질병,3,2,5
E22,2020,광주,질병,0,1,1
E22,2020,서울,질병,7,5,12
E22,2021,대구,질병,1,0,1
E22,2021,부산,질병,1,0,1
E22,2021,서울,질병,5,6,11
E22,2022,대구,질병,1,1,2
E22,2022,대전,질병,2,3,5
E22,2022,서울,질병,8,12,20
E22,2023,대구,질병,0,1,1
E22,2023,부산,질병,1,0,1
E22,2023,서울,질병,9,2,11
E23,2019,광주,질병,2,1,3
E23,2019,서울,질병,4,2,6
E23,2019,인천,질병,1,0,1
E23,2020,광주,질병,4,17,21
E23,2020,서울,질병,4,10,14
E23,2020,인천,질병,2,0,2
E23,2021,광주,질병,0,1,1
E23,2021,서울,질병,7,9,16
E23,2022,광주,질병,0,3,3
E23,2022,서울,질병,8,7,15
E23,2023,광주,질병,2,41,43
E23,2023,서울,질병,6,9,15
E24,2019,광주,질병,1,0,1
E24,2019,부산,질병,0,1,1
E24,2019,서울,질병,1,0,1
E24,2020,서울,질병,2,3,5
E24,2021,부산,질병,0,3,3
E24,2021,서울,질병,1,1,2
E24,2022,대구,질병,1,0,1
E24,2022,부산,질병,0,5,5
E24,2022,서울,질병,0,2,2
E24,2023,부산,질병,0,3,3
E24,2023,서울,질병,1,2,3
E26,2019,광주,질병,2,0,2
E26,2019,부산,질병,1,1,2
E26,2019,서울,질병,0,1,1
E26,2020,서울,질병,2,2,4
E26,2021,광주,질병,1,0,1
E26,2022,광주,질병,1,0,1
E26,2022,부산,질병,1,0,1
E26,2022,서울,질병,2,1,3
E26,2023,광주,질병,1,1,2
E26,2023,부산,질병,0,2,2
E26,2023,서울,질병,1,0,1
E27,2019,광주,질병,2,0,2
E27,2019,대구,질병,3,0,3
E27,2019,대전,질병,1,1,2
E27,2019,서울,질병,36,28,64
E27,2019,인천,질병,1,0,1
E27,2020,광주,질병,0,1,1
E27,2020,대구,질병,4,2,6
E27,2020,대전,질병,1,5,6
E27,2020,서울,질병,66,53,119
E27,2021,광주,질병,4,0,4
E27,2021,대구,질병,2,2,4
E27,2021,대전,질병,0,1,1
E27,2021,서울,질병,52,38,90
E27,2022,광주,질병,1,2,3
E27,2022,대구,질병,4,0,4
E27,2022,대전,질병,2,3,5
E27,2022,서울,질병,53,33,86
E27,2023,광주,질병,1,4,5
E27,2023,대구,질병,2,1,3
E27,2023,대전,질병,1,0,1
E27,2023,부산,질병,0,1,1
E27,2023,서울,질병,38,29,67
E28,2019,서울,질병,0,1,1
E29,2019,서울,질병,1,0,1
E30,2019,광주,질병,0,122,122
E30,2020,광주,질병,0,239,239
E30,2021,광주,질병,0,3,3
E30,2022,광주,질병,0,20,20
E30,2023,광주,질병,0,14,14
E32,2019,서울,질병,1,1,2
E32,2020,서울,질병,1,0,1
E32,2022,서울,질병,1,1,2
E32,2023,서울,질병,2,2,4
E34,2019,광주,질병,0,14,14
E34,2020,광주,질병,0,38,38
E34,2020,서울,질병,0,1,1
E34,2021,광주,질병,0,6,6
E34,2022,광주,질병,0,37,37
E34,2023,광주,질병,0,43,43
E35,2019,대구,질병,1,1,2
E35,2020,대구,질병,1,0,1
E35,2021,대구,질병,1,0,1
E35,2022,대구,질병,1,0,1
E43,2021,인천,질병,1,1,2
E46,2019,대구,질병,0,2,2
E46,2019,서울,질병,1,0,1
E46,2019,인천,질병,10,5,15
E46,2020,인천,질병,4,6,10
E46,2021,대전,질병,2,0,2
E46,2021,인천,질병,0,1,1
E46,2022,대전,질병,1,0,1
E46,2023,대전,질병,0,1,1
E46,2023,서울,질병,1,0,1
E51,2019,광주,질병,0,1,1
E51,2019,서울,질병,4,2,6
E51,2020,광주,질병,1,1,2
E51,2020,서울,질병,1,2,3
E51,2021,광주,질병,0,1,1
E51,2021,대전,질병,0,1,1
E51,2021,서울,질병,1,1,2
E51,2022,서울,질병,1,2,3
E53,2019,서울,질병,2,1,3
E53,2020,대전,질병,0,2,2
E53,2020,서울,질병,4,0,4
E53,2021,광주,질병,0,1,1
E53,2021,대전,질병,0,1,1
E53,2022,대전,질병,1,0,1
E53,2022,서울,질병,1,2,3
E53,2023,서울,질병,0,1,1
E55,2019,대구,질병,0,3,3
E55,2019,대전,질병,0,1,1
E55,2019,서울,질병,0,1,1
E55,2020,서울,질병,3,3,6
E55,2021,서울,질병,3,6,9
E55,2022,서울,질병,3,3,6
E55,2023,대구,질병,4,1,5
E55,2023,서울,질병,18,9,27
E56,2019,서울,질병,1,0,1
E56,2021,서울,질병,1,0,1
E58,2020,서울,질병,1,0,1
E61,2019,대구,질병,2,0,2
E63,2020,대전,질병,4,2,6
E63,2020,서울,질병,0,1,1
E63,2021,대전,질병,8,5,13
E63,2022,대전,질병,8,6,14
E63,2023,대전,질병,7,5,12
E64,2019,서울,질병,1,0,1
E66,2019,광주,질병,1,0,1
E66,2019,서울,질병,3,0,3
E66,2020,광주,질병,0,1,1
E66,2020,서울,질병,3,2,5
E66,2021,광주,질병,0,4,4
E66,2021,서울,질병,0,1,1
E66,2022,서울,질병,3,4,7
E66,2023,서울,질병,1,0,1
E72,2019,대구,질병,1,0,1
E72,2019,서울,질병,1,1,2
E72,2020,서울,질병,0,1,1
E72,2021,서울,질병,0,1,1
E75,2019,서울,질병,3,1,4
E75,2019,인천,질병,1,0,1
E75,2020,서울,질병,1,2,3
E75,2021,서울,질병,1,0,1
E75,2022,서울,질병,0,2,2
E75,2023,서울,질병,1,1,2
E76,2020,서울,질병,1,0,1
E78,2019,광주,질병,0,1,1
E78,2019,대구,질병,119,57,176
E78,2019,대전,질병,76,16,92
E78,2019,부산,질병,36,2,38
E78,2019,서울,질병,224,142,366
E78,2019,인천,질병,1,0,1
E78,2020,광주,질병,0,1,1
E78,2020,대구,질병,105,39,144
E78,2020,대전,질병,91,27,118
E78,2020,서울,질병,225,178,403
E78,2020,인천,질병,0,1,1
E78,2021,광주,질병,0,1,1
E78,2021,대구,질병,42,21,63
E78,2021,대전,질병,63,15,78
E78,2021,부산,질병,31,4,35
E78,2021,서울,질병,276,522,798
E78,2022,광주,질병,1,0,1
E78,2022,대구,질병,72,39,111
E78,2022,대전,질병,48,8,56
E78,2022,부산,질병,27,0,27
E78,2022,서울,질병,36,160,196
E78,2023,광주,질병,4,2,6
E78,2023,대구,질병,50,29,79
E78,2023,대전,질병,54,16,70
E78,2023,부산,질병,15,3,18
E78,2023,서울,질병,19,22,41
E79,2019,대전,질병,1,0,1
E79,2019,부산,질병,1,0,1
E79,2019,서울,질병,1,1,2
E79,2020,대구,질병,2,0,2
E79,2020,대전,질병,2,1,3
E79,2020,서울,질병,2,3,5
E79,2021,대구,질병,1,0,1
E79,2021,대전,질병,3,0,3
E79,2021,서울,질병,3,1,4
E79,2022,대전,질병,1,1,2
E79,2022,서울,질병,3,1,4
E79,2023,대구,질병,1,0,1
E79,2023,대전,질병,2,2,4
E79,2023,서울,질병,2,3,5
E80,2019,광주,질병,0,1,1
E80,2019,서울,질병,2,1,3
E80,2020,대전,질병,2,0,2
E80,2020,서울,질병,6,2,8
E80,2021,광주,질병,1,0,1
E80,2021,대전,질병,0,1,1
E80,2021,서울,질병,0,1,1
E80,2022,서울,질병,0,3,3
E83,2019,광주,질병,0,1,1
E83,2019,부산,질병,1,0,1
E83,2019,서울,질병,3,8,11
E83,2020,서울,질병,5,9,14
E83,2021,부산,질병,1,0,1
E83,2021,서울,질병,8,7,15
E83,2022,대구,질병,2,0,2
E83,2022,서울,질병,4,9,13
E83,2023,대구,질병,1,0,1
E83,2023,서울,질병,8,14,22
E85,2019,광주,질병,0,1,1
E85,2019,부산,질병,1,0,1
E85,2019,서울,질병,3,2,5
E85,2020,서울,질병,1,1,2
E85,2021,서울,질병,9,5,14
E85,2022,부산,질병,1,0,1
E85,2022,서울,질병,10,10,20
E85,2023,서울,질병,4,2,6
E86,2019,대구,질병,0,2,2
E86,2019,대전,질병,2,3,5
E86,2019,서울,질병,4,4,8
E86,2020,대전,질병,2,2,4
E86,2020,서울,질병,4,11,15
E86,2021,대구,질병,0,1,1
E86,2021,대전,질병,1,1,2
E86,2021,서울,질병,3,1,4
E86,2022,서울,질병,4,7,11
E86,2023,대구,질병,2,1,3
E86,2023,대전,질병,2,2,4
E86,2023,서울,질병,3,8,11
E87,2019,광주,질병,16,13,29
E87,2019,대구,질병,33,16,49
E87,2019,대전,질병,18,25,43
E87,2019,부산,질병,22,4,26
E87,2019,서울,질병,80,52,132
E87,2019,인천,질병,2,0,2
E87,2020,광주,질병,7,12,19
E87,2020,대구,질병,30,23,53
E87,2020,대전,질병,18,21,39
E87,2020,서울,질병,98,112,210
E87,2020,인천,질병,3,1,4
E87,2021,광주,질병,5,12,17
E87,2021,대구,질병,23,15,38
E87,2021,대전,질병,25,25,50
E87,2021,부산,질병,19,8,27
E87,2021,서울,질병,65,63,128
E87,2021,인천,질병,1,0,1
E87,2022,광주,질병,2,4,6
E87,2022,대구,질병,24,22,46
E87,2022,대전,질병,29,34,63
E87,2022,부산,질병,5,3,8
E87,2022,서울,질병,116,99,215
E87,2022,인천,질병,0,1,1
E87,2023,광주,질병,5,10,15
E87,2023,대구,질병,17,14,31
E87,2023,대전,질병,16,8,24
E87,2023,부산,질병,4,2,6
E87,2023,서울,질병,93,93,186
E87,2023,인천,질병,1,1,2
E88,2019,광주,질병,1,0,1
E88,2019,대구,질병,1,1,2
E88,2019,부산,질병,0,3,3
E88,2019,서울,질병,7,2,9
E88,2020,광주,질병,1,0,1
E88,2020,서울,질병,6,5,11
E88,2021,대구,질병,2,1,3
E88,2021,서울,질병,4,1,5
E88,2022,광주,질병,2,0,2
E88,2022,부산,질병,0,1,1
E88,2022,서울,질병,3,5,8
E88,2023,광주,질병,1,1,2
E88,2023,대구,질병,1,0,1
E88,2023,서울,질병,2,5,7
E89,2019,서울,질병,41,22,63
E89,2020,광주,질병,0,1,1
E89,2020,서울,질병,37,37,74
E89,2021,서울,질병,70,39,109
E89,2022,서울,질병,60,38,98
E89,2023,서울,질병,61,58,119
F00,2019,광주,질병,8,8,16
F00,2019,대구,질병,20,10,30
F00,2019,대전,질병,7,1,8
F00,2019,부산,질병,14,1,15
F00,2019,서울,질병,99,44,143
F00,2019,인천,질병,1,5,6
F00,2020,광주,질병,6,14,20
F00,2020,대구,질병,13,6,19
F00,2020,대전,질병,5,1,6
F00,2020,서울,질병,76,61,137
F00,2020,인천,질병,0,3,3
F00,2021,광주,질병,12,25,37
F00,2021,대구,질병,6,6,12
F00,2021,부산,질병,6,2,8
F00,2021,서울,질병,87,38,125
F00,2022,광주,질병,20,23,43
F00,2022,대구,질병,5,7,12
F00,2022,대전,질병,1,1,2
F00,2022,부산,질병,7,0,7
F00,2022,서울,질병,94,35,129
F00,2022,인천,질병,1,2,3
F00,2023,광주,질병,9,7,16
F00,2023,대구,질병,7,1,8
F00,2023,대전,질병,2,0,2
F00,2023,부산,질병,5,4,9
F00,2023,서울,질병,152,78,230
F00,2023,인천,질병,17,19,36
F01,2019,광주,질병,0,1,1
F01,2019,대전,질병,2,0,2
F01,2019,부산,질병,1,1,2
F01,2019,서울,질병,111,65,176
F01,2020,광주,질병,0,2,2
F01,2020,대전,질병,2,0,2
F01,2020,서울,질병,100,60,160
F01,2021,광주,질병,2,0,2
F01,2021,대구,질병,0,1,1
F01,2021,대전,질병,2,0,2
F01,2021,부산,질병,2,0,2
F01,2021,서울,질병,36,13,49
F01,2021,인천,질병,0,1,1
F01,2022,광주,질병,0,2,2
F01,2022,대전,질병,2,0,2
F01,2022,부산,질병,2,1,3
F01,2022,서울,질병,29,9,38
F01,2023,광주,질병,4,1,5
F01,2023,대전,질병,0,1,1
F01,2023,부산,질병,3,0,3
F01,2023,서울,질병,51,24,75
F01,2023,인천,질병,1,0,1
F02,2019,서울,질병,19,6,25
F02,2020,서울,질병,51,16,67
F02,2021,서울,질병,40,11,51
F02,2022,광주,질병,4,0,4
F02,2022,서울,질병,22,9,31
F02,2023,광주,질병,1,0,1
F02,2023,서울,질병,47,21,68
F03,2019,광주,질병,1,0,1
F03,2019,대구,질병,5,8,13
F03,2019,대전,질병,17,7,24
F03,2019,부산,질병,6,0,6
F03,2019,서울,질병,250,305,555
F03,2020,광주,질병,3,2,5
F03,2020,대구,질병,4,6,10
F03,2020,대전,질병,14,4,18
F03,2020,서울,질병,242,300,542
F03,2021,광주,질병,3,1,4
F03,2021,대구,질병,4,11,15
F03,2021,대전,질병,4,4,8
F03,2021,부산,질병,1,0,1
F03,2021,서울,질병,218,231,449
F03,2022,광주,질병,2,1,3
F03,2022,대구,질병,4,3,7
F03,2022,대전,질병,14,7,21
F03,2022,부산,질병,3,1,4
F03,2022,서울,질병,116,156,272
F03,2022,인천,질병,1,0,1
F03,2023,광주,질병,4,8,12
F03,2023,대구,질병,1,0,1
F03,2023,대전,질병,12,5,17
F03,2023,부산,질병,1,1,2
F03,2023,서울,질병,168,205,373
F05,2019,광주,질병,0,1,1
F05,2019,대구,질병,2,13,15
F05,2019,대전,질병,2,0,2
F05,2019,서울,질병,110,127,237
F05,2019,인천,질병,0,1,1
F05,2020,광주,질병,1,0,1
F05,2020,대구,질병,5,9,14
F05,2020,대전,질병,1,1,2
F05,2020,서울,질병,192,168,360
F05,2021,대구,질병,5,4,9
F05,2021,대전,질병,3,2,5
F05,2021,서울,질병,140,199,339
F05,2021,인천,질병,0,2,2
F05,2022,대구,질병,4,7,11
F05,2022,대전,질병,3,7,10
F05,2022,부산,질병,0,1,1
F05,2022,서울,질병,250,235,485
F05,2023,광주,질병,0,3,3
F05,2023,대구,질병,2,0,2
F05,2023,대전,질병,2,1,3
F05,2023,부산,질병,1,0,1
F05,2023,서울,질병,246,264,510
F05,2023,인천,질병,1,1,2
F06,2019,광주,질병,0,1,1
F06,2019,대구,질병,2,0,2
F06,2019,대전,질병,1,1,2
F06,2019,부산,질병,1,0,1
F06,2019,서울,질병,13,6,19
F06,2019,인천,질병,1,1,2
F06,2020,광주,질병,0,1,1
F06,2020,대전,질병,3,0,3
F06,2020,서울,질병,16,12,28
F06,2021,대구,질병,1,0,1
F06,2021,대전,질병,1,0,1
F06,2021,서울,질병,11,5,16
F06,2021,인천,질병,1,0,1
F06,2022,대구,질병,2,0,2
F06,2022,대전,질병,4,1,5
F06,2022,서울,질병,17,8,25
F06,2023,부산,질병,1,0,1
F06,2023,서울,질병,13,12,25
F06,2023,인천,질병,1,5,6
F07,2019,서울,질병,5,0,5
F07,2020,서울,질병,2,1,3
F07,2021,서울,질병,1,0,1
F07,2022,서울,질병,1,0,1
F07,2022,인천,질병,2,0,2
F07,2023,광주,질병,1,0,1
F07,2023,대전,질병,1,0,1
F07,2023,부산,질병,1,0,1
F09,2019,대구,질병,0,1,1
F09,2019,서울,질병,1,0,1
F09,2020,서울,질병,1,1,2
F09,2021,서울,질병,0,1,1
F10,2019,광주,질병,1,0,1
F10,2019,대구,질병,3,2,5
F10,2019,대전,질병,1,5,6
F10,2019,부산,질병,1,1,2
F10,2019,서울,질병,46,31,77
F10,2019,인천,질병,0,1,1
F10,2020,광주,질병,0,1,1
F10,2020,대구,질병,2,0,2
F10,2020,대전,질병,2,1,3
F10,2020,서울,질병,45,29,74
F10,2021,광주,질병,2,1,3
F10,2021,대구,질병,0,1,1
F10,2021,대전,질병,1,0,1
F10,2021,부산,질병,1,0,1
F10,2021,서울,질병,24,26,50
F10,2022,대전,질병,1,2,3
F10,2022,부산,질병,0,1,1
F10,2022,서울,질병,24,33,57
F10,2023,대구,질병,1,0,1
F10,2023,대전,질병,1,1,2
F10,2023,서울,질병,36,21,57
F10,2023,인천,질병,1,0,1
F11,2020,대전,질병,1,0,1
F11,2021,서울,질병,0,1,1
F11,2022,서울,질병,1,1,2
F13,2019,광주,질병,1,0,1
F13,2022,대전,질병,0,1,1
F13,2022,서울,질병,2,0,2
F13,2023,서울,질병,1,0,1
F17,2020,서울,질병,2,0,2
F17,2021,서울,질병,2,0,2
F17,2022,서울,질병,0,1,1
F17,2023,서울,질병,1,0,1
F18,2021,대전,질병,1,0,1
F19,2019,대구,질병,1,0,1
F19,2019,서울,질병,2,5,7
F19,2020,서울,질병,1,1,2
F19,2021,서울,질병,1,0,1
F19,2022,광주,질병,0,1,1
F19,2022,서울,질병,0,1,1
F20,2019,대전,질병,1,1,2
F20,2019,서울,질병,82,45,127
F20,2020,대구,질병,0,1,1
F20,2020,서울,질병,75,42,117
F20,2021,서울,질병,55,40,95
F20,2022,대구,질병,3,0,3
F20,2022,대전,질병,0,1,1
F20,2022,서울,질병,50,46,96
F20,2023,대구,질병,0,1,1
F20,2023,대전,질병,0,1,1
F20,2023,서울,질병,61,41,102
F21,2020,서울,질병,0,1,1
F22,2019,대구,질병,1,0,1
F22,2019,대전,질병,2,0,2
F22,2019,서울,질병,3,4,7
F22,2020,서울,질병,7,4,11
F22,2021,서울,질병,1,0,1
F22,2022,대전,질병,1,0,1
F22,2022,서울,질병,4,2,6
F22,2023,서울,질병,2,2,4
F23,2019,대구,질병,4,0,4
F23,2020,대구,질병,1,0,1
F23,2022,대전,질병,1,0,1
F25,2019,서울,질병,7,3,10
F25,2020,서울,질병,9,4,13
F25,2021,서울,질병,9,2,11
F25,2022,서울,질병,5,2,7
F25,2023,서울,질병,5,4,9
F28,2019,서울,질병,1,0,1
F29,2019,대전,질병,7,0,7
F29,2019,서울,질병,0,1,1
F29,2020,대구,질병,1,0,1
F29,2020,대전,질병,5,0,5
F29,2020,서울,질병,1,3,4
F29,2021,대전,질병,5,0,5
F29,2021,서울,질병,2,0,2
F29,2022,대구,질병,1,0,1
F29,2022,대전,질병,6,0,6
F29,2022,서울,질병,2,3,5
F29,2023,대전,질병,4,0,4
F29,2023,서울,질병,1,0,1
F30,2019,대전,질병,1,0,1
F30,2023,서울,질병,1,0,1
F31,2019,대구,질병,4,0,4
F31,2019,대전,질병,4,0,4
F31,2019,부산,질병,1,0,1
F31,2019,서울,질병,28,15,43
F31,2020,대전,질병,3,0,3
F31,2020,서울,질병,19,13,32
F31,2021,대구,질병,1,0,1
F31,2021,대전,질병,3,0,3
F31,2021,서울,질병,12,16,28
F31,2022,대전,질병,0,1,1
F31,2022,부산,질병,0,1,1
F31,2022,서울,질병,15,11,26
F31,2023,대구,질병,1,0,1
F31,2023,대전,질병,1,0,1
F31,2023,서울,질병,13,12,25
F32,2019,광주,질병,0,4,4
F32,2019,대구,질병,30,12,42
F32,2019,대전,질병,29,2,31
F32,2019,부산,질병,7,0,7
F32,2019,서울,질병,52,55,107
F32,2019,인천,질병,2,4,6
F32,2020,대구,질병,29,8,37
F32,2020,대전,질병,25,3,28
F32,2020,서울,질병,65,49,114
F32,2021,대구,질병,3,5,8
F32,2021,대전,질병,19,3,22
F32,2021,부산,질병,8,0,8
F32,2021,서울,질병,45,32,77
F32,2022,대구,질병,9,6,15
F32,2022,대전,질병,13,4,17
F32,2022,부산,질병,2,0,2
F32,2022,서울,질병,51,45,96
F32,2023,광주,질병,1,1,2
F32,2023,대구,질병,9,6,15
F32,2023,대전,질병,13,3,16
F32,2023,부산,질병,1,0,1
F32,2023,서울,질병,67,47,114
F33,2019,대전,질병,2,0,2
F33,2019,서울,질병,2,5,7
F33,2020,서울,질병,3,4,7
F33,2021,대전,질병,2,0,2
F33,2021,부산,질병,1,0,1
F33,2021,서울,질병,1,0,1
F33,2022,대전,질병,1,1,2
F33,2022,서울,질병,4,2,6
F33,2023,대전,질병,1,0,1
F33,2023,서울,질병,2,3,5
F34,2019,서울,질병,1,0,1
F34,2020,서울,질병,2,1,3
F34,2022,서울,질병,2,1,3
F34,2023,서울,질병,3,0,3
F38,2020,서울,질병,0,1,1
F38,2023,서울,질병,2,0,2
F39,2019,서울,질병,4,0,4
F39,2020,서울,질병,4,1,5
F39,2021,서울,질병,3,2,5
F39,2022,서울,질병,12,3,15
F39,2023,서울,질병,6,2,8
F40,2019,서울,질병,1,0,1
F40,2020,대구,질병,2,0,2
F40,2020,서울,질병,0,3,3
F40,2021,서울,질병,0,2,2
F40,2022,광주,질병,0,1,1
F40,2022,대구,질병,1,3,4
F40,2023,대구,질병,2,1,3
F41,2019,광주,질병,0,3,3
F41,2019,대구,질병,7,4,11
F41,2019,대전,질병,3,1,4
F41,2019,부산,질병,0,1,1
F41,2019,서울,질병,21,17,38
F41,2020,광주,질병,1,1,2
F41,2020,대구,질병,10,1,11
F41,2020,대전,질병,5,0,5
F41,2020,서울,질병,29,23,52
F41,2020,인천,질병,0,1,1
F41,2021,광주,질병,1,1,2
F41,2021,대구,질병,6,2,8
F41,2021,대전,질병,6,2,8
F41,2021,서울,질병,20,15,35
F41,2022,대구,질병,4,1,5
F41,2022,대전,질병,2,1,3
F41,2022,부산,질병,0,1,1
F41,2022,서울,질병,18,13,31
F41,2023,대구,질병,7,3,10
F41,2023,대전,질병,1,0,1
F41,2023,부산,질병,2,0,2
F41,2023,서울,질병,23,15,38
F42,2019,서울,질병,0,1,1
F42,2020,서울,질병,0,2,2
F43,2019,광주,질병,2,0,2
F43,2019,대구,질병,2,1,3
F43,2019,대전,질병,4,0,4
F43,2019,서울,질병,4,0,4
F43,2020,대전,질병,2,1,3
F43,2020,서울,질병,9,5,14
F43,2021,대구,질병,2,0,2
F43,2021,대전,질병,2,0,2
F43,2021,서울,질병,6,10,16
F43,2022,광주,질병,0,1,1
F43,2022,서울,질병,22,13,35
F43,2023,광주,질병,1,0,1
F43,2023,대구,질병,1,0,1
F43,2023,서울,질병,20,7,27
F44,2020,서울,질병,1,1,2
F44,2021,서울,질병,0,1,1
F44,2022,서울,질병,0,1,1
F44,2023,서울,질병,0,1,1
F45,2019,대구,질병,0,1,1
F45,2019,서울,질병,1,2,3
F45,2020,광주,질병,0,2,2
F45,2020,대구,질병,1,0,1
F45,2020,서울,질병,2,0,2
F45,2021,대구,질병,0,2,2
F45,2021,대전,질병,0,3,3
F45,2021,서울,질병,2,1,3
F45,2022,광주,질병,1,0,1
F45,2022,대전,질병,0,3,3
F45,2022,부산,질병,0,1,1
F45,2022,서울,질병,2,1,3
F45,2023,대구,질병,0,2,2
F45,2023,서울,질병,1,3,4
F48,2019,부산,질병,1,0,1
F48,2019,서울,질병,0,1,1
F48,2021,부산,질병,1,0,1
F48,2022,부산,질병,1,2,3
F48,2023,부산,질병,1,0,1
F51,2019,대구,질병,15,4,19
F51,2019,대전,질병,4,0,4
F51,2019,부산,질병,6,2,8
F51,2019,서울,질병,14,8,22
F51,2020,대구,질병,8,8,16
F51,2020,대전,질병,1,0,1
F51,2020,서울,질병,11,9,20
F51,2021,대구,질병,2,0,2
F51,2021,대전,질병,3,0,3
F51,2021,부산,질병,10,0,10
F51,2021,서울,질병,3,3,6
F51,2022,광주,질병,1,0,1
F51,2022,대구,질병,15,5,20
F51,2022,대전,질병,3,1,4
F51,2022,부산,질병,8,0,8
F51,2022,서울,질병,4,5,9
F51,2023,대구,질병,8,1,9
F51,2023,대전,질병,7,2,9
F51,2023,부산,질병,7,0,7
F51,2023,서울,질병,10,8,18
F52,2022,서울,질병,1,0,1
F60,2019,서울,질병,1,0,1
F60,2021,서울,질병,0,2,2
F60,2022,서울,질병,0,1,1
F60,2023,서울,질병,1,0,1
F61,2020,서울,질병,1,0,1
F63,2019,서울,질병,1,1,2
F63,2020,서울,질병,2,0,2
F63,2021,서울,질병,0,1,1
F65,2021,서울,질병,1,0,1
F70,2019,서울,질병,0,2,2
F70,2022,서울,질병,0,1,1
F79,2022,서울,질병,0,1,1
F80,2020,서울,질병,0,1,1
F80,2022,서울,질병,1,0,1
F80,2023,서울,질병,1,0,1
F84,2022,서울,질병,0,1,1
F90,2019,대전,질병,3,0,3
F90,2020,대전,질병,2,0,2
F90,2023,서울,질병,1,1,2
F95,2019,부산,질병,2,0,2
F98,2019,서울,질병,0,2,2
F98,2020,서울,질병,1,0,1
F99,2019,서울,질병,1,0,1
F99,2023,서울,질병,1,0,1
G00,2019,대전,질병,1,0,1
G00,2019,서울,질병,2,2,4
G00,2020,서울,질병,0,1,1
G00,2021,서울,질병,0,1,1
G00,2022,부산,질병,0,1,1
G00,2022,서울,질병,2,1,3
G00,2023,서울,질병,2,2,4
G01,2020,서울,질병,2,1,3
G02,2022,서울,질병,0,1,1
G03,2019,광주,질병,1,6,7
G03,2019,대전,질병,1,0,1
G03,2019,서울,질병,3,5,8
G03,2020,대전,질병,1,0,1
G03,2020,서울,질병,3,5,8
G03,2021,광주,질병,0,1,1
G03,2021,서울,질병,3,1,4
G03,2023,광주,질병,0,1,1
G03,2023,부산,질병,3,1,4
G03,2023,서울,질병,2,2,4
G04,2019,광주,질병,1,0,1
G04,2019,서울,질병,6,2,8
G04,2020,대구,질병,2,0,2
G04,2020,서울,질병,7,4,11
G04,2021,광주,질병,0,1,1
G04,2021,대구,질병,0,2,2
G04,2021,서울,질병,3,3,6
G04,2022,대구,질병,2,0,2
G04,2022,부산,질병,1,1,2
G04,2022,서울,질병,2,0,2
G04,2023,광주,질병,0,1,1
G04,2023,대구,질병,1,2,3
G04,2023,서울,질병,6,1,7
G04,2023,인천,질병,0,1,1
G05,2023,서울,질병,0,1,1
G06,2019,광주,질병,1,0,1
G06,2019,대구,질병,1,0,1
G06,2019,부산,질병,3,0,3
G06,2019,서울,질병,3,0,3
G06,2020,광주,질병,1,2,3
G06,2020,서울,질병,8,3,11
G06,2021,광주,질병,0,1,1
G06,2021,대구,질병,1,1,2
G06,2021,부산,질병,0,3,3
G06,2021,서울,질병,8,3,11
G06,2021,인천,질병,2,1,3
G06,2022,대구,질병,2,0,2
G06,2022,서울,질병,4,1,5
G06,2022,인천,질병,1,0,1
G06,2023,부산,질병,0,1,1
G06,2023,서울,질병,4,8,12
G08,2023,서울,질병,1,0,1
G09,2019,서울,질병,0,1,1
G09,2021,서울,질병,0,1,1
G10,2019,서울,질병,2,0,2
G10,2022,서울,질병,1,0,1
G11,2019,서울,질병,1,2,3
G11,2019,인천,질병,0,1,1
G11,2020,광주,질병,0,1,1
G11,2020,서울,질병,3,0,3
G11,2021,대전,질병,0,1,1
G11,2021,서울,질병,0,1,1
G11,2023,서울,질병,2,2,4
G12,2019,광주,질병,2,3,5
G12,2019,대구,질병,0,1,1
G12,2019,대전,질병,1,0,1
G12,2019,서울,질병,12,5,17
G12,2020,광주,질병,1,1,2
G12,2020,대전,질병,1,0,1
G12,2020,서울,질병,11,4,15
G12,2021,광주,질병,1,0,1
G12,2021,대전,질병,1,0,1
G12,2021,부산,질병,2,0,2
G12,2021,서울,질병,0,2,2
G12,2022,광주,질병,3,1,4
G12,2022,대구,질병,1,0,1
G12,2022,대전,질병,1,0,1
G12,2022,부산,질병,1,0,1
G12,2022,서울,질병,0,2,2
G12,2023,부산,질병,3,0,3
G12,2023,서울,질병,1,2,3
G13,2019,서울,질병,2,0,2
G20,2019,광주,질병,24,14,38
G20,2019,대구,질병,7,3,10
G20,2019,대전,질병,13,8,21
G20,2019,부산,질병,3,2,5
G20,2019,서울,질병,319,115,434
G20,2019,인천,질병,17,0,17
G20,2020,광주,질병,29,18,47
G20,2020,대구,질병,13,3,16
G20,2020,대전,질병,6,2,8
G20,2020,서울,질병,318,116,434
G20,2020,인천,질병,6,0,6
G20,2021,광주,질병,25,25,50
G20,2021,대구,질병,6,11,17
G20,2021,대전,질병,3,3,6
G20,2021,부산,질병,5,1,6
G20,2021,서울,질병,278,66,344
G20,2021,인천,질병,2,3,5
G20,2022,광주,질병,31,15,46
G20,2022,대구,질병,4,5,9
G20,2022,대전,질병,11,3,14
G20,2022,부산,질병,13,2,15
G20,2022,서울,질병,308,76,384
G20,2023,대구,질병,10,3,13
G20,2023,대전,질병,5,5,10
G20,2023,부산,질병,16,0,16
G20,2023,서울,질병,366,105,471
G20,2023,인천,질병,4,6,10
G21,2019,광주,질병,6,0,6
G21,2019,대구,질병,2,1,3
G21,2019,서울,질병,18,0,18
G21,2020,광주,질병,14,0,14
G21,2020,서울,질병,14,3,17
G21,2021,광주,질병,9,2,11
G21,2021,대구,질병,2,0,2
G21,2021,서울,질병,21,3,24
G21,2022,광주,질병,6,3,9
G21,2022,대구,질병,4,0,4
G21,2022,서울,질병,19,1,20
G21,2023,광주,질병,13,2,15
G21,2023,대구,질병,4,0,4
G21,2023,대전,질병,1,0,1
G21,2023,서울,질병,28,5,33
G22,2019,광주,질병,1,0,1
G22,2019,대구,질병,1,0,1
G22,2019,대전,질병,7,2,9
G22,2019,부산,질병,0,1,1
G22,2019,서울,질병,1,0,1
G22,2020,광주,질병,2,0,2
G22,2020,대구,질병,1,0,1
G22,2020,대전,질병,5,0,5
G22,2020,서울,질병,1,0,1
G22,2021,광주,질병,2,0,2
G22,2021,대구,질병,1,0,1
G22,2021,대전,질병,4,0,4
G22,2021,서울,질병,0,1,1
G22,2022,대구,질병,1,0,1
G22,2022,대전,질병,1,0,1
G22,2023,광주,질병,2,1,3
G22,2023,부산,질병,1,0,1
G22,2023,서울,질병,3,0,3
G23,2019,서울,질병,16,2,18
G23,2020,서울,질병,14,1,15
G23,2021,부산,질병,1,0,1
G23,2021,서울,질병,25,3,28
G23,2022,광주,질병,1,0,1
G23,2022,서울,질병,20,7,27
G23,2023,광주,질병,1,0,1
G23,2023,서울,질병,18,7,25
G24,2019,광주,질병,0,1,1
G24,2019,서울,질병,3,0,3
G24,2020,광주,질병,1,0,1
G24,2020,서울,질병,5,0,5
G24,2021,광주,질병,1,0,1
G24,2021,서울,질병,2,0,2
G24,2022,대구,질병,1,0,1
G24,2022,부산,질병,1,0,1
G24,2022,서울,질병,0,1,1
G24,2023,광주,질병,1,0,1
G24,2023,부산,질병,1,1,2
G24,2023,서울,질병,0,1,1
G25,2019,광주,질병,1,4,5
G25,2019,대구,질병,3,2,5
G25,2019,대전,질병,1,1,2
G25,2019,부산,질병,6,2,8
G25,2019,서울,질병,23,8,31
G25,2019,인천,질병,3,0,3
G25,2020,광주,질병,3,5,8
G25,2020,대구,질병,4,2,6
G25,2020,서울,질병,14,12,26
G25,2020,인천,질병,0,1,1
G25,2021,광주,질병,0,1,1
G25,2021,대구,질병,0,3,3
G25,2021,부산,질병,5,0,5
G25,2021,서울,질병,15,9,24
G25,2022,광주,질병,0,1,1
G25,2022,대구,질병,1,0,1
G25,2022,부산,질병,2,0,2
G25,2022,서울,질병,13,11,24
G25,2023,광주,질병,1,1,2
G25,2023,대구,질병,1,1,2
G25,2023,부산,질병,3,0,3
G25,2023,서울,질병,24,14,38
G26,2020,대구,질병,1,0,1
G30,2019,광주,질병,2,1,3
G30,2019,대구,질병,2,6,8
G30,2019,대전,질병,7,1,8
G30,2019,서울,질병,116,55,171
G30,2019,인천,질병,0,3,3
G30,2020,대구,질병,5,8,13
G30,2020,대전,질병,7,1,8
G30,2020,서울,질병,92,70,162
G30,2021,광주,질병,0,1,1
G30,2021,대구,질병,1,3,4
G30,2021,대전,질병,6,4,10
G30,2021,서울,질병,93,42,135
G30,2022,광주,질병,1,1,2
G30,2022,대구,질병,5,2,7
G30,2022,대전,질병,7,1,8
G30,2022,서울,질병,101,40,141
G30,2023,대구,질병,5,1,6
G30,2023,대전,질병,5,0,5
G30,2023,서울,질병,153,82,235
G30,2023,인천,질병,0,1,1
G31,2019,광주,질병,0,1,1
G31,2019,대구,질병,0,1,1
G31,2019,부산,질병,7,0,7
G31,2019,서울,질병,15,0,15
G31,2020,광주,질병,1,0,1
G31,2020,대구,질병,0,1,1
G31,2020,서울,질병,4,6,10
G31,2021,광주,질병,1,0,1
G31,2021,부산,질병,12,4,16
G31,2021,서울,질병,5,2,7
G31,2021,인천,질병,1,0,1
G31,2022,부산,질병,9,1,10
G31,2022,서울,질병,6,3,9
G31,2023,대전,질병,1,0,1
G31,2023,부산,질병,9,0,9
G31,2023,서울,질병,19,5,24
G31,2023,인천,질병,0,1,1
G32,2019,대전,질병,1,0,1
G32,2019,서울,질병,1,0,1
G32,2022,서울,질병,0,2,2
G35,2019,광주,질병,0,2,2
G35,2019,서울,질병,2,1,3
G35,2022,광주,질병,0,1,1
G35,2022,서울,질병,1,0,1
G36,2019,광주,질병,1,1,2
G36,2020,광주,질병,0,1,1
G36,2020,서울,질병,0,1,1
G36,2022,서울,질병,1,1,2
G36,2023,서울,질병,0,2,2
G37,2019,서울,질병,1,0,1
G37,2020,광주,질병,0,1,1
G37,2020,서울,질병,1,1,2
G37,2021,서울,질병,1,1,2
G37,2022,광주,질병,0,1,1
G37,2022,부산,질병,0,1,1
G37,2023,광주,질병,0,2,2
G37,2023,서울,질병,1,0,1
G37,2023,인천,질병,0,1,1
G40,2019,광주,질병,3,7,10
G40,2019,대구,질병,2,2,4
G40,2019,대전,질병,5,3,8
G40,2019,부산,질병,12,2,14
G40,2019,서울,질병,14,7,21
G40,2020,광주,질병,2,0,2
G40,2020,대구,질병,1,0,1
G40,2020,대전,질병,5,5,10
G40,2020,서울,질병,19,19,38
G40,2021,광주,질병,0,1,1
G40,2021,대구,질병,2,0,2
G40,2021,대전,질병,5,4,9
G40,2021,부산,질병,9,5,14
G40,2021,서울,질병,10,14,24
G40,2022,대구,질병,2,0,2
G40,2022,대전,질병,2,0,2
G40,2022,부산,질병,10,0,10
G40,2022,서울,질병,11,12,23
G40,2023,광주,질병,5,2,7
G40,2023,대전,질병,10,1,11
G40,2023,부산,질병,4,0,4
G40,2023,서울,질병,12,20,32
G40,2023,인천,질병,2,0,2
G41,2019,광주,질병,2,0,2
G41,2019,서울,질병,2,2,4
G41,2020,서울,질병,4,7,11
G41,2021,대구,질병,2,1,3
G41,2021,대전,질병,1,0,1
G41,2021,부산,질병,1,0,1
G41,2021,서울,질병,0,3,3
G41,2022,광주,질병,1,2,3
G41,2022,대구,질병,2,0,2
G41,2022,대전,질병,0,1,1
G41,2022,서울,질병,2,6,8
G41,2023,광주,질병,0,1,1
G41,2023,서울,질병,6,7,13
G43,2019,광주,질병,7,80,87
G43,2019,대구,질병,0,1,1
G43,2019,부산,질병,4,0,4
G43,2019,서울,질병,2,5,7
G43,2019,인천,질병,0,1,1
G43,2020,광주,질병,4,88,92
G43,2020,대전,질병,0,1,1
G43,2020,서울,질병,4,4,8
G43,2021,광주,질병,9,58,67
G43,2021,부산,질병,1,1,2
G43,2021,서울,질병,5,0,5
G43,2022,광주,질병,0,50,50
G43,2022,대전,질병,1,0,1
G43,2022,부산,질병,1,0,1
G43,2022,서울,질병,2,4,6
G43,2023,광주,질병,2,3,5
G43,2023,부산,질병,2,1,3
G43,2023,서울,질병,5,3,8
G44,2019,광주,질병,4,11,15
G44,2019,대구,질병,1,0,1
G44,2019,대전,질병,0,1,1
G44,2019,부산,질병,1,2,3
G44,2019,서울,질병,2,5,7
G44,2020,광주,질병,4,6,10
G44,2020,대구,질병,1,2,3
G44,2020,대전,질병,0,2,2
G44,2020,서울,질병,7,7,14
G44,2020,인천,질병,1,0,1
G44,2021,광주,질병,2,2,4
G44,2021,대전,질병,0,1,1
G44,2021,부산,질병,2,3,5
G44,2021,서울,질병,3,4,7
G44,2021,인천,질병,1,1,2
G44,2022,광주,질병,1,2,3
G44,2022,대구,질병,1,0,1
G44,2022,부산,질병,0,1,1
G44,2022,서울,질병,4,4,8
G44,2023,광주,질병,2,11,13
G44,2023,대전,질병,0,2,2
G44,2023,부산,질병,0,2,2
G44,2023,서울,질병,0,4,4
G44,2023,인천,질병,1,2,3
G45,2019,광주,질병,5,8,13
G45,2019,대전,질병,10,2,12
G45,2019,부산,질병,5,0,5
G45,2019,서울,질병,17,15,32
G45,2019,인천,질병,0,3,3
G45,2020,광주,질병,10,9,19
G45,2020,대구,질병,1,1,2
G45,2020,대전,질병,3,4,7
G45,2020,서울,질병,11,8,19
G45,2021,광주,질병,10,12,22
G45,2021,대구,질병,2,2,4
G45,2021,대전,질병,6,3,9
G45,2021,부산,질병,8,0,8
G45,2021,서울,질병,9,14,23
G45,2021,인천,질병,0,4,4
G45,2022,광주,질병,3,4,7
G45,2022,대전,질병,2,1,3
G45,2022,부산,질병,4,1,5
G45,2022,서울,질병,16,13,29
G45,2022,인천,질병,0,1,1
G45,2023,광주,질병,8,4,12
G45,2023,대구,질병,3,0,3
G45,2023,대전,질병,2,2,4
G45,2023,부산,질병,6,0,6
G45,2023,서울,질병,11,17,28
G45,2023,인천,질병,1,0,1
G46,2019,광주,질병,1,0,1
G46,2019,서울,질병,4,1,5
G46,2020,광주,질병,1,1,2
G46,2020,서울,질병,4,2,6
G46,2020,인천,질병,0,1,1
G46,2021,광주,질병,2,1,3
G46,2022,서울,질병,0,1,1
G46,2023,광주,질병,0,1,1
G46,2023,대구,질병,1,0,1
G46,2023,서울,질병,0,1,1
G47,2019,광주,질병,0,1,1
G47,2019,대구,질병,11,9,20
G47,2019,대전,질병,12,2,14
G47,2019,부산,질병,11,1,12
G47,2019,서울,질병,37,34,71
G47,2019,인천,질병,0,4,4
G47,2020,광주,질병,1,2,3
G47,2020,대구,질병,10,8,18
G47,2020,대전,질병,22,2,24
G47,2020,서울,질병,60,39,99
G47,2021,대구,질병,8,2,10
G47,2021,대전,질병,15,0,15
G47,2021,부산,질병,7,1,8
G47,2021,서울,질병,57,55,112
G47,2022,대구,질병,5,6,11
G47,2022,대전,질병,9,5,14
G47,2022,부산,질병,10,4,14
G47,2022,서울,질병,57,49,106
G47,2023,광주,질병,0,1,1
G47,2023,대구,질병,11,3,14
G47,2023,대전,질병,10,1,11
G47,2023,부산,질병,12,0,12
G47,2023,서울,질병,58,40,98
G50,2019,광주,질병,0,2,2
G50,2019,대전,질병,0,1,1
G50,2019,부산,질병,2,0,2
G50,2019,서울,질병,6,3,9
G50,2019,인천,질병,0,2,2
G50,2020,광주,질병,0,2,2
G50,2020,서울,질병,6,0,6
G50,2020,인천,질병,1,0,1
G50,2021,부산,질병,1,0,1
G50,2021,서울,질병,5,2,7
G50,2022,부산,질병,2,0,2
G50,2022,서울,질병,2,0,2
G50,2023,광주,질병,0,3,3
G50,2023,부산,질병,1,0,1
G50,2023,서울,질병,3,0,3
G51,2019,광주,질병,4,11,15
G51,2019,대구,질병,2,0,2
G51,2019,대전,질병,3,3,6
G51,2019,부산,질병,3,1,4
G51,2019,서울,질병,16,18,34
G51,2020,광주,질병,11,13,24
G51,2020,대전,질병,3,0,3
G51,2020,서울,질병,19,13,32
G51,2020,인천,질병,1,0,1
G51,2021,광주,질병,4,16,20
G51,2021,대구,질병,1,2,3
G51,2021,대전,질병,4,0,4
G51,2021,부산,질병,1,0,1
G51,2021,서울,질병,20,18,38
G51,2021,인천,질병,0,1,1
G51,2022,광주,질병,3,7,10
G51,2022,대구,질병,1,0,1
G51,2022,대전,질병,2,0,2
G51,2022,서울,질병,10,14,24
G51,2023,광주,질병,6,2,8
G51,2023,대구,질병,1,0,1
G51,2023,대전,질병,4,2,6
G51,2023,부산,질병,2,2,4
G51,2023,서울,질병,15,15,30
G52,2019,부산,질병,1,0,1
G52,2021,광주,질병,0,1,1
G52,2023,광주,질병,0,1,1
G53,2019,광주,질병,0,2,2
G53,2019,대구,질병,1,1,2
G53,2019,대전,질병,2,0,2
G53,2019,부산,질병,2,0,2
G53,2019,서울,질병,10,7,17
G53,2020,광주,질병,0,4,4
G53,2020,대구,질병,0,1,1
G53,2020,대전,질병,2,0,2
G53,2020,서울,질병,10,8,18
G53,2020,인천,질병,0,2,2
G53,2021,광주,질병,8,3,11
G53,2021,대구,질병,3,1,4
G53,2021,대전,질병,3,2,5
G53,2021,부산,질병,1,0,1
G53,2021,서울,질병,5,7,12
G53,2021,인천,질병,0,1,1
G53,2022,대구,질병,2,2,4
G53,2022,대전,질병,0,1,1
G53,2022,부산,질병,2,0,2
G53,2022,서울,질병,2,3,5
G53,2023,광주,질병,1,3,4
G53,2023,대구,질병,1,3,4
G53,2023,대전,질병,2,2,4
G53,2023,부산,질병,2,0,2
G53,2023,서울,질병,2,5,7
G54,2019,광주,질병,6,2,8
G54,2019,대전,질병,3,0,3
G54,2019,부산,질병,1,1,2
G54,2019,서울,질병,1,0,1
G54,2020,광주,질병,2,1,3
G54,2020,대구,질병,1,0,1
G54,2020,대전,질병,2,0,2
G54,2020,서울,질병,1,0,1
G54,2020,인천,질병,0,1,1
G54,2021,광주,질병,2,0,2
G54,2021,대구,질병,0,1,1
G54,2021,대전,질병,4,0,4
G54,2021,부산,질병,6,0,6
G54,2021,인천,질병,0,1,1
G54,2022,광주,질병,5,3,8
G54,2022,대전,질병,4,0,4
G54,2022,부산,질병,39,3,42
G54,2022,서울,질병,5,1,6
G54,2023,광주,질병,13,4,17
G54,2023,대전,질병,3,0,3
G54,2023,부산,질병,21,0,21
G54,2023,서울,질병,2,1,3
G55,2019,대구,질병,27,7,34
G55,2019,대전,질병,63,11,74
G55,2019,부산,질병,129,41,170
G55,2019,서울,질병,54,13,67
G55,2019,인천,질병,2,4,6
G55,2020,광주,질병,1,0,1
G55,2020,대구,질병,31,10,41
G55,2020,대전,질병,57,5,62
G55,2020,서울,질병,26,13,39
G55,2020,인천,질병,0,1,1
G55,2021,대구,질병,86,11,97
G55,2021,대전,질병,49,7,56
G55,2021,서울,질병,15,10,25
G55,2021,인천,질병,0,4,4
G55,2022,대구,질병,150,20,170
G55,2022,대전,질병,47,5,52
G55,2022,서울,질병,22,12,34
G55,2022,인천,질병,0,3,3
G55,2023,대구,질병,178,12,190
G55,2023,대전,질병,95,16,111
G55,2023,부산,질병,1,0,1
G55,2023,서울,질병,99,72,171
G55,2023,인천,질병,1,1,2
G56,2019,광주,질병,7,6,13
G56,2019,대구,질병,14,3,17
G56,2019,대전,질병,9,8,17
G56,2019,부산,질병,22,8,30
G56,2019,서울,질병,57,33,90
G56,2019,인천,질병,1,3,4
G56,2020,광주,질병,7,8,15
G56,2020,대구,질병,5,7,12
G56,2020,대전,질병,7,4,11
G56,2020,서울,질병,34,39,73
G56,2020,인천,질병,3,3,6
G56,2021,광주,질병,8,11,19
G56,2021,대구,질병,8,4,12
G56,2021,대전,질병,10,4,14
G56,2021,부산,질병,23,2,25
G56,2021,서울,질병,23,13,36
G56,2021,인천,질병,0,2,2
G56,2022,광주,질병,1,2,3
G56,2022,대구,질병,8,1,9
G56,2022,대전,질병,4,3,7
G56,2022,부산,질병,12,3,15
G56,2022,서울,질병,15,16,31
G56,2022,인천,질병,0,1,1
G56,2023,광주,질병,1,2,3
G56,2023,대구,질병,8,6,14
G56,2023,대전,질병,7,2,9
G56,2023,부산,질병,8,3,11
G56,2023,서울,질병,28,24,52
G56,2023,인천,질병,3,3,6
G57,2019,광주,질병,1,2,3
G57,2019,대구,질병,3,0,3
G57,2019,대전,질병,3,0,3
G57,2019,서울,질병,3,1,4
G57,2019,인천,질병,0,1,1
G57,2020,대전,질병,4,0,4
G57,2020,서울,질병,4,1,5
G57,2020,인천,질병,0,2,2
G57,2021,광주,질병,0,1,1
G57,2021,대구,질병,1,0,1
G57,2021,대전,질병,3,1,4
G57,2021,부산,질병,2,0,2
G57,2021,서울,질병,1,3,4
G57,2021,인천,질병,0,1,1
G57,2022,대전,질병,2,1,3
G57,2022,서울,질병,3,2,5
G57,2022,인천,질병,0,1,1
G57,2023,광주,질병,1,1,2
G57,2023,대구,질병,1,1,2
G57,2023,대전,질병,1,0,1
G57,2023,서울,질병,1,1,2
G58,2019,광주,질병,3,3,6
G58,2019,대구,질병,3,1,4
G58,2019,서울,질병,0,1,1
G58,2020,광주,질병,1,0,1
G58,2020,대구,질병,0,1,1
G58,2020,서울,질병,1,1,2
G58,2021,광주,질병,1,0,1
G58,2021,부산,질병,17,1,18
G58,2021,서울,질병,0,1,1
G58,2022,부산,질병,31,6,37
G58,2022,서울,질병,1,1,2
G58,2023,광주,질병,3,0,3
G58,2023,부산,질병,34,0,34
G58,2023,서울,질병,1,0,1
G59,2019,대구,질병,3,0,3
G59,2020,대구,질병,4,1,5
G59,2020,서울,질병,1,0,1
G59,2022,서울,질병,0,1,1
G59,2023,대구,질병,1,0,1
G60,2019,광주,질병,3,0,3
G60,2019,대구,질병,1,0,1
G60,2019,부산,질병,1,0,1
G60,2020,광주,질병,1,1,2
G60,2020,대구,질병,2,0,2
G60,2020,대전,질병,3,0,3
G60,2020,서울,질병,1,0,1
G60,2021,광주,질병,2,0,2
G60,2021,대구,질병,3,0,3
G60,2021,대전,질병,2,0,2
G60,2021,부산,질병,3,0,3
G60,2022,광주,질병,3,0,3
G60,2022,대구,질병,6,0,6
G60,2022,부산,질병,4,0,4
G60,2022,서울,질병,1,2,3
G60,2023,광주,질병,4,0,4
G60,2023,대구,질병,5,0,5
G60,2023,부산,질병,4,0,4
G60,2023,인천,질병,1,0,1
G61,2019,광주,질병,0,4,4
G61,2019,대전,질병,1,0,1
G61,2019,서울,질병,9,1,10
G61,2020,대구,질병,2,0,2
G61,2020,서울,질병,3,1,4
G61,2021,광주,질병,7,2,9
G61,2021,대구,질병,1,0,1
G61,2021,부산,질병,1,0,1
G61,2021,서울,질병,5,1,6
G61,2022,광주,질병,3,0,3
G61,2022,대구,질병,4,1,5
G61,2022,서울,질병,8,5,13
G61,2022,인천,질병,0,1,1
G61,2023,광주,질병,2,0,2
G61,2023,대구,질병,3,2,5
G61,2023,서울,질병,3,3,6
G62,2019,광주,질병,4,2,6
G62,2019,대구,질병,4,1,5
G62,2019,대전,질병,15,0,15
G62,2019,부산,질병,3,0,3
G62,2019,서울,질병,56,6,62
G62,2020,광주,질병,6,2,8
G62,2020,대구,질병,11,0,11
G62,2020,대전,질병,8,1,9
G62,2020,서울,질병,20,22,42
G62,2021,광주,질병,6,3,9
G62,2021,대구,질병,16,1,17
G62,2021,대전,질병,9,0,9
G62,2021,부산,질병,4,0,4
G62,2021,서울,질병,11,5,16
G62,2022,광주,질병,7,2,9
G62,2022,대구,질병,26,0,26
G62,2022,대전,질병,11,0,11
G62,2022,부산,질병,12,1,13
G62,2022,서울,질병,19,4,23
G62,2022,인천,질병,2,0,2
G62,2023,광주,질병,12,0,12
G62,2023,대구,질병,29,0,29
G62,2023,대전,질병,10,0,10
G62,2023,부산,질병,7,0,7
G62,2023,서울,질병,15,5,20
G63,2019,광주,질병,5,0,5
G63,2019,대구,질병,35,15,50
G63,2019,대전,질병,60,5,65
G63,2019,부산,질병,3,1,4
G63,2019,서울,질병,45,24,69
G63,2020,광주,질병,4,1,5
G63,2020,대구,질병,28,7,35
G63,2020,대전,질병,48,6,54
G63,2020,서울,질병,43,14,57
G63,2021,광주,질병,3,0,3
G63,2021,대구,질병,30,4,34
G63,2021,대전,질병,35,3,38
G63,2021,부산,질병,4,0,4
G63,2021,서울,질병,34,12,46
G63,2022,대구,질병,37,4,41
G63,2022,대전,질병,30,2,32
G63,2022,부산,질병,0,1,1
G63,2022,서울,질병,13,3,16
G63,2023,대구,질병,33,1,34
G63,2023,대전,질병,56,7,63
G63,2023,서울,질병,36,8,44
G64,2021,대구,질병,1,0,1
G64,2023,부산,질병,1,0,1
G70,2019,광주,질병,0,1,1
G70,2019,서울,질병,2,1,3
G70,2020,광주,질병,0,1,1
G70,2020,대구,질병,1,0,1
G70,2020,서울,질병,3,1,4
G70,2021,서울,질병,1,1,2
G70,2022,서울,질병,3,3,6
G70,2023,서울,질병,1,6,7
G71,2020,서울,질병,0,2,2
G71,2021,서울,질병,0,1,1
G71,2023,서울,질병,0,2,2
G72,2019,서울,질병,1,1,2
G72,2020,서울,질병,1,0,1
G72,2022,서울,질병,0,1,1
G72,2023,광주,질병,0,1,1
G72,2023,대전,질병,4,0,4
G72,2023,인천,질병,1,0,1
G73,2019,서울,질병,2,0,2
G73,2020,서울,질병,1,0,1
G73,2021,광주,질병,1,0,1
G73,2021,서울,질병,0,1,1
G73,2022,광주,질병,2,0,2
G73,2022,서울,질병,4,5,9
G73,2023,광주,질병,4,0,4
G73,2023,서울,질병,2,0,2
G80,2019,광주,질병,0,1,1
G80,2021,광주,질병,1,0,1
G80,2022,대구,질병,1,0,1
G80,2023,광주,질병,1,0,1
G80,2023,대구,질병,1,0,1
G80,2023,서울,질병,0,1,1
G81,2019,광주,질병,2,1,3
G81,2019,대구,질병,19,3,22
G81,2019,대전,질병,24,3,27
G81,2019,부산,질병,27,3,30
G81,2019,서울,질병,231,125,356
G81,2020,광주,질병,3,2,5
G81,2020,대구,질병,24,4,28
G81,2020,대전,질병,24,3,27
G81,2020,서울,질병,216,129,345
G81,2021,광주,질병,8,2,10
G81,2021,대구,질병,42,5,47
G81,2021,대전,질병,24,3,27
G81,2021,부산,질병,25,1,26
G81,2021,서울,질병,93,56,149
G81,2021,인천,질병,3,7,10
G81,2022,광주,질병,21,16,37
G81,2022,대구,질병,50,9,59
G81,2022,대전,질병,19,1,20
G81,2022,부산,질병,37,5,42
G81,2022,서울,질병,113,62,175
G81,2022,인천,질병,7,2,9
G81,2023,광주,질병,13,9,22
G81,2023,대구,질병,56,8,64
G81,2023,대전,질병,23,5,28
G81,2023,부산,질병,53,14,67
G81,2023,서울,질병,170,114,284
G81,2023,인천,질병,4,12,16
G82,2019,광주,질병,6,3,9
G82,2019,대구,질병,5,8,13
G82,2019,대전,질병,21,0,21
G82,2019,부산,질병,12,1,13
G82,2019,서울,질병,159,108,267
G82,2020,광주,질병,9,1,10
G82,2020,대구,질병,9,2,11
G82,2020,대전,질병,17,1,18
G82,2020,서울,질병,135,93,228
G82,2021,광주,질병,3,1,4
G82,2021,대구,질병,6,4,10
G82,2021,대전,질병,18,3,21
G82,2021,부산,질병,12,2,14
G82,2021,서울,질병,49,27,76
G82,2021,인천,질병,5,1,6
G82,2022,광주,질병,6,3,9
G82,2022,대구,질병,11,2,13
G82,2022,대전,질병,15,0,15
G82,2022,부산,질병,11,3,14
G82,2022,서울,질병,72,25,97
G82,2022,인천,질병,1,2,3
G82,2023,광주,질병,5,5,10
G82,2023,대구,질병,15,4,19
G82,2023,대전,질병,38,2,40
G82,2023,부산,질병,20,3,23
G82,2023,서울,질병,66,56,122
G82,2023,인천,질병,1,1,2
G83,2019,광주,질병,1,0,1
G83,2019,대전,질병,5,2,7
G83,2019,부산,질병,2,0,2
G83,2019,서울,질병,3,1,4
G83,2020,광주,질병,0,1,1
G83,2020,대구,질병,1,0,1
G83,2020,대전,질병,3,1,4
G83,2020,서울,질병,3,1,4
G83,2020,인천,질병,0,1,1
G83,2021,대구,질병,3,0,3
G83,2021,대전,질병,5,1,6
G83,2021,부산,질병,16,0,16
G83,2021,서울,질병,2,1,3
G83,2022,광주,질병,3,2,5
G83,2022,대구,질병,5,3,8
G83,2022,대전,질병,4,1,5
G83,2022,부산,질병,13,0,13
G83,2022,서울,질병,4,3,7
G83,2023,광주,질병,4,5,9
G83,2023,대구,질병,4,2,6
G83,2023,대전,질병,2,2,4
G83,2023,부산,질병,7,2,9
G83,2023,서울,질병,1,1,2
G90,2019,서울,질병,3,1,4
G90,2020,서울,질병,0,3,3
G90,2021,광주,질병,2,3,5
G90,2021,대전,질병,2,0,2
G90,2021,부산,질병,6,0,6
G90,2021,서울,질병,18,2,20
G90,2021,인천,질병,5,0,5
G90,2022,광주,질병,2,2,4
G90,2022,대구,질병,1,0,1
G90,2022,부산,질병,6,0,6
G90,2022,서울,질병,19,2,21
G90,2022,인천,질병,1,0,1
G90,2023,광주,질병,3,1,4
G90,2023,대구,질병,1,0,1
G90,2023,대전,질병,2,0,2
G90,2023,부산,질병,5,0,5
G90,2023,서울,질병,16,4,20
G91,2019,광주,질병,4,0,4
G91,2019,대구,질병,2,0,2
G91,2019,대전,질병,2,0,2
G91,2019,부산,질병,8,0,8
G91,2019,서울,질병,69,51,120
G91,2020,광주,질병,1,0,1
G91,2020,대구,질병,5,0,5
G91,2020,대전,질병,1,0,1
G91,2020,서울,질병,45,28,73
G91,2020,인천,질병,0,1,1
G91,2021,광주,질병,0,1,1
G91,2021,대구,질병,5,1,6
G91,2021,대전,질병,2,0,2
G91,2021,부산,질병,9,0,9
G91,2021,서울,질병,26,13,39
G91,2022,대구,질병,2,0,2
G91,2022,대전,질병,1,0,1
G91,2022,부산,질병,14,0,14
G91,2022,서울,질병,20,19,39
G91,2023,광주,질병,0,1,1
G91,2023,대구,질병,1,0,1
G91,2023,부산,질병,15,0,15
G91,2023,서울,질병,33,25,58
G91,2023,인천,질병,0,2,2
G92,2020,서울,질병,1,2,3
G93,2019,광주,질병,1,2,3
G93,2019,대구,질병,1,2,3
G93,2019,대전,질병,0,2,2
G93,2019,부산,질병,0,2,2
G93,2019,서울,질병,29,21,50
G93,2020,광주,질병,1,1,2
G93,2020,대구,질병,0,2,2
G93,2020,대전,질병,0,1,1
G93,2020,서울,질병,20,17,37
G93,2021,광주,질병,1,1,2
G93,2021,대구,질병,0,1,1
G93,2021,대전,질병,1,0,1
G93,2021,서울,질병,14,6,20
G93,2022,광주,질병,0,1,1
G93,2022,대구,질병,2,1,3
G93,2022,부산,질병,1,0,1
G93,2022,서울,질병,29,6,35
G93,2023,대전,질병,1,1,2
G93,2023,부산,질병,0,1,1
G93,2023,서울,질병,15,12,27
G94,2019,서울,질병,1,0,1
G94,2020,서울,질병,0,1,1
G94,2021,서울,질병,4,2,6
G94,2022,서울,질병,1,3,4
G94,2023,광주,질병,2,0,2
G94,2023,대구,질병,1,0,1
G94,2023,서울,질병,5,1,6
G95,2019,광주,질병,12,5,17
G95,2019,대전,질병,10,4,14
G95,2019,부산,질병,6,1,7
G95,2019,서울,질병,21,10,31
G95,2020,광주,질병,21,3,24
G95,2020,대구,질병,2,1,3
G95,2020,대전,질병,8,2,10
G95,2020,서울,질병,25,11,36
G95,2021,광주,질병,23,5,28
G95,2021,대구,질병,1,0,1
G95,2021,대전,질병,9,4,13
G95,2021,부산,질병,7,0,7
G95,2021,서울,질병,10,5,15
G95,2022,광주,질병,11,6,17
G95,2022,대구,질병,8,0,8
G95,2022,대전,질병,7,0,7
G95,2022,부산,질병,13,0,13
G95,2022,서울,질병,17,11,28
G95,2022,인천,질병,3,5,8
G95,2023,광주,질병,26,6,32
G95,2023,대구,질병,9,0,9
G95,2023,대전,질병,18,6,24
G95,2023,부산,질병,22,3,25
G95,2023,서울,질병,14,17,31
G95,2023,인천,질병,1,2,3
G96,2019,서울,질병,15,3,18
G96,2020,서울,질병,7,1,8
G96,2021,서울,질병,7,1,8
G96,2022,서울,질병,4,0,4
G96,2023,서울,질병,2,1,3
G97,2019,서울,질병,1,0,1
G97,2020,서울,질병,2,0,2
G97,2021,서울,질병,1,1,2
G97,2022,서울,질병,4,0,4
G97,2023,서울,질병,1,1,2
G98,2019,서울,질병,3,1,4
G98,2020,서울,질병,2,1,3
G98,2021,서울,질병,0,2,2
G98,2022,서울,질병,0,1,1
G99,2019,대구,질병,0,1,1
G99,2019,대전,질병,3,1,4
G99,2019,부산,질병,1,0,1
G99,2019,서울,질병,14,12,26
G99,2020,대구,질병,2,0,2
G99,2020,대전,질병,4,0,4
G99,2020,서울,질병,20,19,39
G99,2021,대전,질병,3,0,3
G99,2021,서울,질병,11,9,20
G99,2022,대구,질병,1,0,1
G99,2022,대전,질병,2,2,4
G99,2022,서울,질병,12,10,22
G99,2023,광주,질병,1,0,1
G99,2023,대구,질병,8,0,8
G99,2023,대전,질병,4,2,6
G99,2023,서울,질병,35,23,58
H00,2019,대구,질병,1,0,1
H00,2019,대전,질병,1,1,2
H00,2019,부산,질병,1,0,1
H00,2019,서울,질병,2,3,5
H00,2020,대구,질병,0,1,1
H00,2020,서울,질병,4,3,7
H00,2021,서울,질병,7,1,8
H00,2022,서울,질병,2,0,2
H00,2023,대전,질병,1,0,1
H00,2023,서울,질병,3,2,5
H01,2019,대전,질병,20,12,32
H01,2019,부산,질병,1,0,1
H01,2019,서울,질병,6,0,6
H01,2020,대전,질병,14,2,16
H01,2020,서울,질병,1,3,4
H01,2021,대전,질병,20,9,29
H01,2021,서울,질병,2,1,3
H01,2022,대구,질병,1,0,1
H01,2022,대전,질병,16,14,30
H01,2022,서울,질병,0,2,2
H01,2023,서울,질병,4,1,5
H02,2019,대구,질병,5,2,7
H02,2019,대전,질병,6,2,8
H02,2019,서울,질병,38,11,49
H02,2020,대구,질병,1,0,1
H02,2020,대전,질병,4,0,4
H02,2020,서울,질병,21,17,38
H02,2021,대구,질병,18,4,22
H02,2021,부산,질병,10,6,16
H02,2021,서울,질병,35,28,63
H02,2022,대구,질병,27,6,33
H02,2022,서울,질병,28,8,36
H02,2023,광주,질병,8,2,10
H02,2023,대구,질병,5,1,6
H02,2023,대전,질병,2,0,2
H02,2023,서울,질병,35,21,56
H03,2019,서울,질병,0,1,1
H03,2020,서울,질병,1,0,1
H04,2019,대구,질병,2,2,4
H04,2019,대전,질병,34,7,41
H04,2019,부산,질병,5,0,5
H04,2019,서울,질병,21,16,37
H04,2020,대구,질병,5,1,6
H04,2020,대전,질병,29,8,37
H04,2020,서울,질병,18,13,31
H04,2021,대구,질병,11,1,12
H04,2021,대전,질병,18,10,28
H04,2021,부산,질병,4,0,4
H04,2021,서울,질병,8,4,12
H04,2022,대구,질병,9,2,11
H04,2022,대전,질병,14,5,19
H04,2022,부산,질병,4,1,5
H04,2022,서울,질병,23,27,50
H04,2023,대구,질병,5,6,11
H04,2023,대전,질병,5,2,7
H04,2023,부산,질병,5,0,5
H04,2023,서울,질병,22,12,34
H05,2019,광주,질병,0,1,1
H05,2019,대구,질병,3,0,3
H05,2019,서울,질병,3,5,8
H05,2020,서울,질병,1,4,5
H05,2021,대구,질병,1,0,1
H05,2021,부산,질병,2,0,2
H05,2021,서울,질병,3,4,7
H05,2022,서울,질병,3,4,7
H05,2023,서울,질병,3,1,4
H06,2019,서울,질병,1,0,1
H06,2023,서울,질병,0,2,2
H10,2019,대구,질병,0,1,1
H10,2019,대전,질병,2,4,6
H10,2019,서울,질병,5,5,10
H10,2020,대전,질병,2,4,6
H10,2020,서울,질병,4,6,10
H10,2021,대전,질병,2,2,4
H10,2021,서울,질병,4,3,7
H10,2022,대전,질병,2,1,3
H10,2022,서울,질병,3,6,9
H10,2023,대전,질병,1,0,1
H10,2023,서울,질병,3,3,6
H11,2019,대구,질병,7,2,9
H11,2019,대전,질병,2,2,4
H11,2019,서울,질병,18,11,29
H11,2020,대구,질병,5,3,8
H11,2020,대전,질병,1,0,1
H11,2020,서울,질병,18,14,32
H11,2021,대구,질병,3,3,6
H11,2021,대전,질병,5,0,5
H11,2021,서울,질병,37,27,64
H11,2022,대구,질병,8,2,10
H11,2022,대전,질병,3,2,5
H11,2022,서울,질병,22,16,38
H11,2023,광주,질병,2,0,2
H11,2023,대구,질병,1,2,3
H11,2023,서울,질병,18,14,32
H13,2020,대구,질병,0,1,1
H13,2021,서울,질병,0,3,3
H13,2022,대전,질병,0,1,1
H13,2023,서울,질병,0,1,1
H15,2019,대전,질병,1,0,1
H15,2019,서울,질병,1,0,1
H15,2020,서울,질병,3,2,5
H15,2021,서울,질병,1,1,2
H16,2019,대전,질병,1,0,1
H16,2019,서울,질병,13,4,17
H16,2020,서울,질병,13,6,19
H16,2021,서울,질병,11,9,20
H16,2022,대구,질병,2,0,2
H16,2022,서울,질병,6,8,14
H16,2023,대구,질병,0,1,1
H16,2023,서울,질병,9,6,15
H17,2020,서울,질병,0,2,2
H17,2021,서울,질병,3,2,5
H17,2022,서울,질병,2,0,2
H18,2019,서울,질병,8,1,9
H18,2020,대구,질병,1,1,2
H18,2020,대전,질병,1,0,1
H18,2020,서울,질병,3,0,3
H18,2021,서울,질병,9,12,21
H18,2022,서울,질병,5,5,10
H18,2023,대구,질병,0,1,1
H18,2023,서울,질병,4,6,10
H19,2019,대구,질병,0,2,2
H19,2019,서울,질병,4,1,5
H19,2020,서울,질병,1,0,1
H19,2021,서울,질병,4,0,4
H19,2022,서울,질병,3,2,5
H19,2023,대구,질병,1,0,1
H19,2023,서울,질병,4,2,6
H20,2019,서울,질병,2,2,4
H20,2019,인천,질병,1,0,1
H20,2020,서울,질병,2,0,2
H20,2021,서울,질병,4,1,5
H20,2022,서울,질병,0,1,1
H20,2023,대구,질병,1,0,1
H20,2023,서울,질병,1,0,1
H21,2019,서울,질병,12,9,21
H21,2020,광주,질병,1,0,1
H21,2020,대구,질병,1,0,1
H21,2020,서울,질병,42,49,91
H21,2021,서울,질병,227,343,570
H21,2022,서울,질병,44,32,76
H21,2023,서울,질병,33,31,64
H22,2020,대전,질병,1,0,1
H22,2021,대전,질병,0,1,1
H22,2022,부산,질병,0,1,1
H25,2019,광주,질병,89,46,135
H25,2019,대구,질병,434,236,670
H25,2019,대전,질병,116,60,176
H25,2019,부산,질병,104,34,138
H25,2019,서울,질병,766,1105,1871
H25,2019,인천,질병,39,92,131
H25,2020,광주,질병,496,251,747
H25,2020,대구,질병,437,184,621
H25,2020,대전,질병,92,51,143
H25,2020,서울,질병,679,925,1604
H25,2020,인천,질병,59,145,204
H25,2021,광주,질병,300,180,480
H25,2021,대구,질병,410,214,624
H25,2021,대전,질병,169,65,234
H25,2021,부산,질병,83,16,99
H25,2021,서울,질병,673,912,1585
H25,2021,인천,질병,75,189,264
H25,2022,광주,질병,36,11,47
H25,2022,대구,질병,332,211,543
H25,2022,대전,질병,172,105,277
H25,2022,부산,질병,4,0,4
H25,2022,서울,질병,513,771,1284
H25,2022,인천,질병,4,4,8
H25,2023,광주,질병,357,229,586
H25,2023,대구,질병,305,221,526
H25,2023,대전,질병,140,109,249
H25,2023,부산,질병,78,44,122
H25,2023,서울,질병,649,884,1533
H25,2023,인천,질병,44,73,117
H26,2019,광주,질병,1,0,1
H26,2019,대전,질병,1,0,1
H26,2019,서울,질병,34,15,49
H26,2020,광주,질병,0,1,1
H26,2020,대구,질병,2,1,3
H26,2020,서울,질병,23,24,47
H26,2021,광주,질병,0,3,3
H26,2021,대구,질병,8,5,13
H26,2021,부산,질병,1,2,3
H26,2021,서울,질병,12,17,29
H26,2021,인천,질병,0,1,1
H26,2022,대구,질병,9,3,12
H26,2022,대전,질병,1,0,1
H26,2022,서울,질병,20,18,38
H26,2023,광주,질병,1,1,2
H26,2023,대구,질병,4,5,9
H26,2023,대전,질병,1,1,2
H26,2023,서울,질병,36,48,84
H26,2023,인천,질병,1,0,1
H27,2019,대구,질병,1,0,1
H27,2019,대전,질병,1,0,1
H27,2019,서울,질병,1,3,4
H27,2020,대구,질병,3,0,3
H27,2020,서울,질병,3,4,7
H27,2021,대구,질병,5,0,5
H27,2021,서울,질병,7,5,12
H27,2022,대구,질병,7,2,9
H27,2022,서울,질병,5,8,13
H27,2023,광주,질병,0,1,1
H27,2023,대구,질병,1,2,3
H27,2023,서울,질병,28,25,53
H28,2019,서울,질병,2,5,7
H30,2022,대전,질병,0,1,1
H30,2023,서울,질병,0,1,1
H31,2019,서울,질병,0,6,6
H31,2020,서울,질병,6,1,7
H31,2021,대구,질병,1,0,1
H31,2021,서울,질병,4,6,10
H31,2022,서울,질병,5,1,6
H31,2023,서울,질병,1,0,1
H32,2019,부산,질병,1,0,1
H32,2021,부산,질병,3,0,3
H32,2023,대전,질병,1,0,1
H33,2019,서울,질병,19,28,47
H33,2020,대구,질병,3,0,3
H33,2020,서울,질병,35,25,60
H33,2021,대구,질병,0,2,2
H33,2021,부산,질병,1,0,1
H33,2021,서울,질병,24,17,41
H33,2022,서울,질병,5,8,13
H33,2023,대구,질병,1,0,1
H33,2023,서울,질병,14,17,31
H34,2019,대구,질병,0,1,1
H34,2019,서울,질병,10,10,20
H34,2020,대구,질병,1,1,2
H34,2020,서울,질병,14,9,23
H34,2021,대구,질병,4,4,8
H34,2021,서울,질병,7,14,21
H34,2022,대구,질병,4,0,4
H34,2022,서울,질병,9,8,17
H34,2023,대구,질병,1,2,3
H34,2023,대전,질병,1,0,1
H34,2023,서울,질병,10,4,14
H35,2019,대구,질병,4,1,5
H35,2019,대전,질병,0,1,1
H35,2019,서울,질병,184,209,393
H35,2020,대구,질병,20,5,25
H35,2020,대전,질병,3,1,4
H35,2020,서울,질병,207,209,416
H35,2021,대구,질병,31,18,49
H35,2021,서울,질병,267,284,551
H35,2022,대구,질병,46,16,62
H35,2022,대전,질병,1,0,1
H35,2022,서울,질병,64,61,125
H35,2023,대구,질병,6,2,8
H35,2023,대전,질병,2,0,2
H35,2023,서울,질병,150,137,287
H36,2019,대구,질병,5,5,10
H36,2019,대전,질병,4,1,5
H36,2019,서울,질병,145,61,206
H36,2020,대구,질병,7,4,11
H36,2020,대전,질병,2,2,4
H36,2020,서울,질병,191,80,271
H36,2021,대구,질병,4,1,5
H36,2021,대전,질병,3,0,3
H36,2021,부산,질병,1,0,1
H36,2021,서울,질병,179,87,266
H36,2022,대구,질병,8,2,10
H36,2022,대전,질병,6,0,6
H36,2022,서울,질병,36,19,55
H36,2023,대구,질병,4,5,9
H36,2023,대전,질병,4,0,4
H36,2023,서울,질병,63,20,83
H40,2019,대구,질병,19,3,22
H40,2019,대전,질병,1,0,1
H40,2019,부산,질병,0,1,1
H40,2019,서울,질병,54,30,84
H40,2020,대구,질병,48,1,49
H40,2020,대전,질병,2,3,5
H40,2020,서울,질병,128,125,253
H40,2021,광주,질병,0,1,1
H40,2021,대구,질병,34,9,43
H40,2021,대전,질병,4,1,5
H40,2021,부산,질병,0,1,1
H40,2021,서울,질병,171,166,337
H40,2022,대구,질병,26,12,38
H40,2022,대전,질병,4,1,5
H40,2022,서울,질병,132,173,305
H40,2023,대구,질병,18,22,40
H40,2023,대전,질병,2,0,2
H40,2023,서울,질병,211,188,399
H42,2020,서울,질병,1,0,1
H42,2022,서울,질병,2,0,2
H43,2019,대구,질병,3,0,3
H43,2019,서울,질병,34,35,69
H43,2020,대구,질병,10,1,11
H43,2020,서울,질병,32,23,55
H43,2021,대구,질병,10,4,14
H43,2021,부산,질병,3,3,6
H43,2021,서울,질병,86,48,134
H43,2022,대구,질병,6,0,6
H43,2022,서울,질병,15,16,31
H43,2023,대구,질병,6,2,8
H43,2023,서울,질병,43,24,67
H44,2019,서울,질병,6,1,7
H44,2020,서울,질병,5,3,8
H44,2021,서울,질병,6,4,10
H44,2022,서울,질병,1,5,6
H44,2023,서울,질병,6,1,7
H45,2021,서울,질병,0,1,1
H45,2023,서울,질병,1,0,1
H46,2019,서울,질병,0,1,1
H46,2020,서울,질병,0,2,2
H46,2021,서울,질병,0,2,2
H46,2022,서울,질병,4,1,5
H46,2023,서울,질병,1,1,2
H47,2021,대구,질병,1,0,1
H47,2021,서울,질병,0,3,3
H47,2023,광주,질병,1,0,1
H47,2023,서울,질병,3,1,4
H48,2019,서울,질병,1,0,1
H49,2019,광주,질병,0,2,2
H49,2019,대전,질병,3,1,4
H49,2019,서울,질병,10,10,20
H49,2020,광주,질병,4,3,7
H49,2020,대전,질병,0,1,1
H49,2020,서울,질병,10,9,19
H49,2020,인천,질병,2,0,2
H49,2021,광주,질병,5,1,6
H49,2021,서울,질병,7,0,7
H49,2022,광주,질병,1,0,1
H49,2022,부산,질병,1,0,1
H49,2022,서울,질병,9,8,17
H49,2023,광주,질병,2,1,3
H49,2023,대전,질병,1,0,1
H49,2023,서울,질병,9,10,19
H50,2019,대구,질병,1,0,1
H50,2019,대전,질병,0,1,1
H50,2019,서울,질병,2,2,4
H50,2020,대구,질병,1,0,1
H50,2020,서울,질병,2,10,12
H50,2021,서울,질병,2,5,7
H50,2022,대구,질병,1,0,1
H50,2022,서울,질병,1,5,6
H50,2023,대전,질병,2,0,2
H50,2023,서울,질병,3,1,4
H51,2019,광주,질병,1,1,2
H51,2021,대구,질병,1,0,1
H51,2021,대전,질병,1,0,1
H52,2019,대구,질병,1,0,1
H52,2019,대전,질병,1,0,1
H52,2019,부산,질병,5,0,5
H52,2019,서울,질병,0,1,1
H52,2020,대전,질병,1,0,1
H52,2020,서울,질병,3,5,8
H52,2021,서울,질병,1,1,2
H52,2022,대전,질병,0,1,1
H52,2023,대구,질병,1,1,2
H52,2023,대전,질병,1,0,1
H52,2023,서울,질병,0,1,1
H53,2019,광주,질병,0,1,1
H53,2019,서울,질병,7,11,18
H53,2020,광주,질병,1,3,4
H53,2020,대구,질병,1,0,1
H53,2020,대전,질병,0,1,1
H53,2020,서울,질병,12,15,27
H53,2021,광주,질병,2,2,4
H53,2021,서울,질병,8,3,11
H53,2022,광주,질병,1,1,2
H53,2022,대구,질병,1,0,1
H53,2022,서울,질병,5,5,10
H53,2023,광주,질병,1,1,2
H53,2023,대구,질병,1,0,1
H53,2023,서울,질병,7,9,16
H54,2019,서울,질병,5,3,8
H54,2020,서울,질병,4,2,6
H54,2021,서울,질병,6,1,7
H54,2022,서울,질병,2,1,3
H54,2023,서울,질병,3,1,4
H55,2019,대구,질병,0,1,1
H55,2022,서울,질병,0,1,1
H55,2023,서울,질병,0,1,1
H57,2020,서울,질병,2,2,4
H57,2021,서울,질병,6,2,8
H57,2022,대구,질병,1,0,1
H57,2022,서울,질병,11,18,29
H57,2023,대구,질병,0,1,1
H57,2023,서울,질병,24,26,50
H58,2021,서울,질병,1,0,1
H59,2019,서울,질병,23,21,44
H59,2020,서울,질병,14,13,27
H59,2021,서울,질병,13,21,34
H59,2022,서울,질병,6,14,20
H59,2023,서울,질병,10,24,34
H60,2019,대구,질병,0,1,1
H60,2019,서울,질병,17,9,26
H60,2020,서울,질병,17,11,28
H60,2020,인천,질병,0,1,1
H60,2021,서울,질병,11,8,19
H60,2022,대구,질병,1,0,1
H60,2022,서울,질병,12,2,14
H60,2023,광주,질병,0,2,2
H60,2023,서울,질병,20,11,31
H61,2019,대전,질병,2,0,2
H61,2019,부산,질병,1,0,1
H61,2019,서울,질병,3,2,5
H61,2019,인천,질병,0,1,1
H61,2020,대전,질병,2,0,2
H61,2020,서울,질병,3,3,6
H61,2020,인천,질병,2,0,2
H61,2021,대전,질병,3,0,3
H61,2021,서울,질병,11,9,20
H61,2022,대전,질병,2,0,2
H61,2022,부산,질병,1,0,1
H61,2022,서울,질병,11,5,16
H61,2023,대전,질병,1,0,1
H61,2023,부산,질병,0,1,1
H61,2023,서울,질병,8,4,12
H62,2019,서울,질병,3,4,7
H62,2020,서울,질병,1,2,3
H62,2021,서울,질병,2,0,2
H62,2022,서울,질병,1,1,2
H62,2023,서울,질병,2,1,3
H65,2019,서울,질병,10,8,18
H65,2020,대전,질병,1,0,1
H65,2020,서울,질병,9,9,18
H65,2021,서울,질병,5,5,10
H65,2022,서울,질병,12,11,23
H65,2023,광주,질병,14,30,44
H65,2023,서울,질병,18,32,50
H65,2023,인천,질병,0,1,1
H66,2019,광주,질병,1,0,1
H66,2019,대전,질병,4,1,5
H66,2019,서울,질병,86,93,179
H66,2019,인천,질병,8,17,25
H66,2020,대구,질병,1,0,1
H66,2020,대전,질병,1,0,1
H66,2020,서울,질병,53,53,106
H66,2020,인천,질병,9,22,31
H66,2021,광주,질병,0,1,1
H66,2021,대구,질병,1,1,2
H66,2021,대전,질병,1,0,1
H66,2021,부산,질병,0,2,2
H66,2021,서울,질병,62,53,115
H66,2021,인천,질병,1,2,3
H66,2022,광주,질병,1,0,1
H66,2022,서울,질병,40,36,76
H66,2022,인천,질병,0,1,1
H66,2023,광주,질병,4,2,6
H66,2023,대구,질병,0,1,1
H66,2023,부산,질병,1,0,1
H66,2023,서울,질병,38,28,66
H68,2022,서울,질병,1,0,1
H68,2023,부산,질병,1,0,1
H69,2021,서울,질병,1,0,1
H69,2022,서울,질병,0,1,1
H69,2023,광주,질병,6,10,16
H69,2023,서울,질병,0,1,1
H70,2019,서울,질병,14,5,19
H70,2020,대구,질병,1,0,1
H70,2020,서울,질병,3,3,6
H70,2022,서울,질병,2,1,3
H70,2023,서울,질병,1,1,2
H71,2019,서울,질병,4,7,11
H71,2019,인천,질병,3,1,4
H71,2020,서울,질병,5,6,11
H71,2020,인천,질병,4,4,8
H71,2021,서울,질병,4,4,8
H71,2022,서울,질병,3,1,4
H71,2023,광주,질병,1,3,4
H71,2023,서울,질병,3,1,4
H72,2019,서울,질병,63,62,125
H72,2020,서울,질병,40,38,78
H72,2021,서울,질병,42,36,78
H72,2022,서울,질병,21,29,50
H72,2023,서울,질병,28,36,64
H73,2019,서울,질병,1,1,2
H73,2020,서울,질병,1,1,2
H73,2021,서울,질병,5,0,5
H73,2022,서울,질병,2,0,2
H74,2021,서울,질병,2,0,2
H80,2019,서울,질병,1,0,1
H81,2019,광주,질병,13,20,33
H81,2019,대구,질병,5,7,12
H81,2019,대전,질병,7,1,8
H81,2019,부산,질병,8,6,14
H81,2019,서울,질병,20,22,42
H81,2019,인천,질병,11,7,18
H81,2020,광주,질병,23,35,58
H81,2020,대구,질병,3,4,7
H81,2020,대전,질병,14,2,16
H81,2020,서울,질병,23,22,45
H81,2020,인천,질병,1,14,15
H81,2021,광주,질병,27,20,47
H81,2021,대구,질병,4,2,6
H81,2021,대전,질병,9,2,11
H81,2021,부산,질병,11,4,15
H81,2021,서울,질병,20,22,42
H81,2021,인천,질병,1,2,3
H81,2022,광주,질병,5,10,15
H81,2022,대구,질병,1,0,1
H81,2022,대전,질병,7,2,9
H81,2022,부산,질병,11,1,12
H81,2022,서울,질병,25,28,53
H81,2022,인천,질병,0,3,3
H81,2023,광주,질병,24,22,46
H81,2023,대구,질병,2,1,3
H81,2023,대전,질병,5,2,7
H81,2023,부산,질병,12,3,15
H81,2023,서울,질병,19,27,46
H81,2023,인천,질병,7,4,11
H82,2019,부산,질병,1,0,1
H82,2023,부산,질병,2,0,2
H83,2020,서울,질병,3,0,3
H83,2021,서울,질병,0,4,4
H83,2023,광주,질병,0,2,2
H83,2023,서울,질병,4,2,6
H90,2019,대구,질병,1,0,1
H90,2019,대전,질병,4,6,10
H90,2019,서울,질병,93,56,149
H90,2019,인천,질병,2,1,3
H90,2020,광주,질병,0,1,1
H90,2020,대구,질병,1,2,3
H90,2020,대전,질병,5,4,9
H90,2020,서울,질병,106,30,136
H90,2020,인천,질병,7,4,11
H90,2021,대전,질병,0,1,1
H90,2021,부산,질병,2,0,2
H90,2021,서울,질병,72,40,112
H90,2021,인천,질병,1,2,3
H90,2022,대구,질병,1,0,1
H90,2022,대전,질병,1,0,1
H90,2022,부산,질병,0,1,1
H90,2022,서울,질병,105,67,172
H90,2023,광주,질병,27,10,37
H90,2023,대전,질병,7,1,8
H90,2023,서울,질병,135,90,225
H90,2023,인천,질병,2,0,2
H91,2019,광주,질병,5,3,8
H91,2019,대구,질병,3,2,5
H91,2019,대전,질병,0,2,2
H91,2019,부산,질병,3,3,6
H91,2019,서울,질병,33,26,59
H91,2020,광주,질병,1,0,1
H91,2020,대구,질병,2,0,2
H91,2020,대전,질병,2,1,3
H91,2020,서울,질병,21,28,49
H91,2021,광주,질병,2,2,4
H91,2021,대구,질병,1,1,2
H91,2021,대전,질병,1,1,2
H91,2021,부산,질병,10,2,12
H91,2021,서울,질병,28,24,52
H91,2022,광주,질병,1,1,2
H91,2022,부산,질병,5,5,10
H91,2022,서울,질병,11,19,30
H91,2023,광주,질병,1,1,2
H91,2023,대구,질병,0,1,1
H91,2023,대전,질병,1,0,1
H91,2023,부산,질병,7,4,11
H91,2023,서울,질병,19,25,44
H92,2019,서울,질병,3,5,8
H92,2020,서울,질병,2,2,4
H92,2021,서울,질병,3,1,4
H92,2022,서울,질병,1,0,1
H92,2023,서울,질병,4,0,4
H93,2019,대구,질병,2,1,3
H93,2019,부산,질병,1,0,1
H93,2019,서울,질병,16,29,45
H93,2020,대전,질병,0,1,1
H93,2020,서울,질병,14,16,30
H93,2021,광주,질병,1,0,1
H93,2021,대구,질병,1,0,1
H93,2021,부산,질병,5,0,5
H93,2021,서울,질병,16,7,23
H93,2022,광주,질병,1,0,1
H93,2022,부산,질병,1,0,1
H93,2022,서울,질병,14,6,20
H93,2023,서울,질병,15,13,28
H94,2019,서울,질병,1,0,1
H94,2020,서울,질병,2,3,5
H94,2021,서울,질병,1,1,2
H94,2022,서울,질병,2,1,3
H94,2023,서울,질병,1,1,2
H95,2021,서울,질병,3,3,6
H95,2022,서울,질병,1,2,3
H95,2023,서울,질병,3,3,6
I01,2022,대전,질병,1,0,1
I01,2023,서울,질병,1,0,1
I05,2019,광주,질병,0,1,1
I05,2019,대구,질병,1,2,3
I05,2019,부산,질병,2,1,3
I05,2019,서울,질병,4,8,12
I05,2020,광주,질병,1,0,1
I05,2020,대구,질병,1,0,1
I05,2020,서울,질병,3,4,7
I05,2021,광주,질병,1,0,1
I05,2021,대구,질병,0,3,3
I05,2021,부산,질병,4,0,4
I05,2021,서울,질병,0,5,5
I05,2022,광주,질병,1,0,1
I05,2022,대구,질병,1,0,1
I05,2022,대전,질병,0,1,1
I05,2022,서울,질병,1,0,1
I05,2023,광주,질병,2,3,5
I05,2023,대구,질병,0,3,3
I05,2023,부산,질병,2,0,2
I06,2019,서울,질병,1,1,2
I06,2020,서울,질병,0,1,1
I06,2021,서울,질병,0,1,1
I06,2022,서울,질병,0,2,2
I06,2023,서울,질병,1,1,2
I07,2019,부산,질병,0,1,1
I07,2019,서울,질병,3,2,5
I07,2020,대전,질병,2,0,2
I07,2020,서울,질병,4,7,11
I07,2021,서울,질병,6,6,12
I07,2022,대전,질병,0,1,1
I07,2022,서울,질병,10,6,16
I07,2023,대구,질병,1,0,1
I07,2023,대전,질병,1,1,2
I07,2023,서울,질병,5,0,5
I08,2019,부산,질병,2,0,2
I08,2019,서울,질병,5,9,14
I08,2020,서울,질병,5,4,9
I08,2021,부산,질병,1,0,1
I08,2021,서울,질병,3,4,7
I08,2022,서울,질병,1,2,3
I08,2023,서울,질병,8,2,10
I09,2021,대구,질병,2,0,2
I10,2019,광주,질병,28,13,41
I10,2019,대구,질병,251,95,346
I10,2019,대전,질병,139,103,242
I10,2019,부산,질병,46,22,68
I10,2019,서울,질병,6260,4964,11224
I10,2019,인천,질병,5,12,17
I10,2020,광주,질병,20,21,41
I10,2020,대구,질병,212,112,324
I10,2020,대전,질병,150,99,249
I10,2020,서울,질병,5847,4729,10576
I10,2020,인천,질병,7,34,41
I10,2021,광주,질병,29,13,42
I10,2021,대구,질병,135,71,206
I10,2021,대전,질병,255,177,432
I10,2021,부산,질병,49,31,80
I10,2021,서울,질병,5095,4560,9655
I10,2021,인천,질병,7,31,38
I10,2022,광주,질병,26,15,41
I10,2022,대구,질병,118,79,197
I10,2022,대전,질병,750,443,1193
I10,2022,부산,질병,45,22,67
I10,2022,서울,질병,5181,4328,9509
I10,2022,인천,질병,3,5,8
I10,2023,광주,질병,73,45,118
I10,2023,대구,질병,98,53,151
I10,2023,대전,질병,235,145,380
I10,2023,부산,질병,40,15,55
I10,2023,서울,질병,6612,0,6612
I10,2023,인천,질병,3,5,8
I11,2019,광주,질병,3,1,4
I11,2019,대구,질병,16,1,17
I11,2019,대전,질병,4,3,7
I11,2019,부산,질병,7,2,9
I11,2019,서울,질병,0,1,1
I11,2020,광주,질병,2,0,2
I11,2020,대구,질병,21,14,35
I11,2020,대전,질병,9,3,12
I11,2020,서울,질병,2,4,6
I11,2021,광주,질병,0,4,4
I11,2021,대구,질병,11,11,22
I11,2021,대전,질병,7,4,11
I11,2021,부산,질병,8,0,8
I11,2021,인천,질병,1,1,2
I11,2022,광주,질병,2,0,2
I11,2022,대구,질병,11,5,16
I11,2022,대전,질병,1,1,2
I11,2022,부산,질병,5,9,14
I11,2022,서울,질병,2,0,2
I11,2023,광주,질병,1,2,3
I11,2023,대구,질병,7,11,18
I11,2023,대전,질병,2,0,2
I11,2023,부산,질병,14,8,22
I11,2023,서울,질병,1,1,2
I12,2019,광주,질병,1,3,4
I12,2019,대구,질병,0,2,2
I12,2019,대전,질병,8,1,9
I12,2019,서울,질병,11,9,20
I12,2020,광주,질병,0,1,1
I12,2020,대전,질병,5,0,5
I12,2020,서울,질병,0,1,1
I12,2021,광주,질병,0,1,1
I12,2021,대전,질병,11,4,15
I12,2021,서울,질병,2,2,4
I12,2022,광주,질병,1,0,1
I12,2022,대전,질병,4,0,4
I12,2022,부산,질병,1,0,1
I12,2022,서울,질병,6,1,7
I12,2023,대전,질병,5,1,6
I12,2023,서울,질병,2,0,2
I13,2019,대구,질병,1,0,1
I13,2019,서울,질병,2,2,4
I13,2020,서울,질병,1,2,3
I13,2023,대구,질병,1,0,1
I13,2023,서울,질병,2,1,3
I15,2019,광주,질병,1,2,3
I15,2019,대구,질병,2,2,4
I15,2019,대전,질병,2,1,3
I15,2019,서울,질병,1,0,1
I15,2020,대전,질병,2,1,3
I15,2020,서울,질병,0,1,1
I15,2021,광주,질병,0,3,3
I15,2021,대전,질병,4,0,4
I15,2021,부산,질병,2,0,2
I15,2021,서울,질병,1,2,3
I15,2022,대구,질병,1,0,1
I15,2022,대전,질병,6,0,6
I15,2022,부산,질병,1,0,1
I15,2023,대전,질병,14,0,14
I15,2023,부산,질병,1,0,1
I15,2023,서울,질병,2,0,2
I20,2019,광주,질병,305,136,441
I20,2019,대구,질병,523,185,708
I20,2019,대전,질병,154,65,219
I20,2019,부산,질병,491,144,635
I20,2019,서울,질병,485,248,733
I20,2019,인천,질병,0,2,2
I20,2020,광주,질병,229,153,382
I20,2020,대구,질병,502,129,631
I20,2020,대전,질병,74,23,97
I20,2020,서울,질병,355,172,527
I20,2020,인천,질병,1,2,3
I20,2021,광주,질병,206,106,312
I20,2021,대구,질병,600,183,783
I20,2021,대전,질병,84,33,117
I20,2021,부산,질병,590,177,767
I20,2021,서울,질병,172,99,271
I20,2021,인천,질병,1,0,1
I20,2022,광주,질병,196,55,251
I20,2022,대구,질병,651,228,879
I20,2022,대전,질병,153,50,203
I20,2022,부산,질병,463,127,590
I20,2022,서울,질병,155,76,231
I20,2023,광주,질병,543,191,734
I20,2023,대구,질병,605,205,810
I20,2023,대전,질병,102,30,132
I20,2023,부산,질병,523,148,671
I20,2023,서울,질병,271,122,393
I21,2019,광주,질병,26,37,63
I21,2019,대구,질병,17,29,46
I21,2019,대전,질병,3,3,6
I21,2019,부산,질병,21,11,32
I21,2019,서울,질병,49,42,91
I21,2019,인천,질병,0,1,1
I21,2020,광주,질병,30,34,64
I21,2020,대구,질병,18,13,31
I21,2020,대전,질병,0,2,2
I21,2020,서울,질병,72,50,122
I21,2021,광주,질병,24,15,39
I21,2021,대구,질병,18,15,33
I21,2021,대전,질병,3,1,4
I21,2021,부산,질병,14,5,19
I21,2021,서울,질병,43,40,83
I21,2022,광주,질병,17,12,29
I21,2022,대구,질병,11,17,28
I21,2022,대전,질병,3,0,3
I21,2022,부산,질병,10,7,17
I21,2022,서울,질병,76,37,113
I21,2023,광주,질병,13,19,32
I21,2023,대구,질병,14,11,25
I21,2023,대전,질병,2,0,2
I21,2023,부산,질병,18,8,26
I21,2023,서울,질병,86,66,152
I22,2023,인천,질병,1,0,1
I23,2019,광주,질병,0,2,2
I23,2023,서울,질병,1,0,1
I24,2019,서울,질병,4,3,7
I24,2020,서울,질병,3,2,5
I24,2021,부산,질병,1,0,1
I24,2021,서울,질병,4,0,4
I24,2022,서울,질병,3,7,10
I24,2023,광주,질병,2,0,2
I24,2023,서울,질병,0,4,4
I25,2019,광주,질병,18,12,30
I25,2019,대구,질병,36,35,71
I25,2019,대전,질병,26,3,29
I25,2019,부산,질병,8,1,9
I25,2019,서울,질병,473,249,722
I25,2019,인천,질병,1,1,2
I25,2020,광주,질병,9,6,15
I25,2020,대구,질병,24,17,41
I25,2020,대전,질병,7,1,8
I25,2020,서울,질병,432,221,653
I25,2021,광주,질병,24,12,36
I25,2021,대구,질병,28,16,44
I25,2021,대전,질병,13,4,17
I25,2021,부산,질병,3,0,3
I25,2021,서울,질병,345,172,517
I25,2021,인천,질병,1,0,1
I25,2022,광주,질병,13,8,21
I25,2022,대구,질병,35,15,50
I25,2022,대전,질병,24,3,27
I25,2022,부산,질병,2,3,5
I25,2022,서울,질병,430,209,639
I25,2023,광주,질병,29,5,34
I25,2023,대구,질병,35,30,65
I25,2023,대전,질병,11,5,16
I25,2023,부산,질병,3,2,5
I25,2023,서울,질병,541,266,807
I25,2023,인천,질병,0,2,2
I26,2019,광주,질병,4,7,11
I26,2019,대구,질병,5,5,10
I26,2019,대전,질병,5,1,6
I26,2019,부산,질병,12,6,18
I26,2019,서울,질병,43,32,75
I26,2020,광주,질병,3,9,12
I26,2020,대구,질병,5,0,5
I26,2020,대전,질병,1,1,2
I26,2020,서울,질병,39,39,78
I26,2020,인천,질병,0,3,3
I26,2021,광주,질병,2,7,9
I26,2021,대구,질병,7,3,10
I26,2021,대전,질병,0,1,1
I26,2021,부산,질병,6,6,12
I26,2021,서울,질병,33,22,55
I26,2022,광주,질병,4,3,7
I26,2022,대구,질병,6,4,10
I26,2022,대전,질병,5,0,5
I26,2022,부산,질병,9,3,12
I26,2022,서울,질병,26,36,62
I26,2023,광주,질병,4,6,10
I26,2023,대구,질병,8,5,13
I26,2023,대전,질병,2,9,11
I26,2023,부산,질병,7,2,9
I26,2023,서울,질병,24,32,56
I27,2019,광주,질병,3,0,3
I27,2019,대구,질병,1,1,2
I27,2019,부산,질병,2,0,2
I27,2019,서울,질병,26,21,47
I27,2019,인천,질병,0,1,1
I27,2020,광주,질병,1,0,1
I27,2020,대전,질병,0,1,1
I27,2020,서울,질병,23,23,46
I27,2021,광주,질병,0,1,1
I27,2021,부산,질병,1,0,1
I27,2021,서울,질병,22,23,45
I27,2022,대구,질병,1,0,1
I27,2022,부산,질병,0,2,2
I27,2022,서울,질병,14,17,31
I27,2023,부산,질병,1,0,1
I27,2023,서울,질병,24,21,45
I28,2022,서울,질병,2,2,4
I30,2019,광주,질병,1,0,1
I30,2020,서울,질병,1,3,4
I30,2021,부산,질병,1,1,2
I30,2021,서울,질병,3,1,4
I30,2022,광주,질병,1,0,1
I30,2022,대구,질병,2,0,2
I30,2022,부산,질병,1,0,1
I30,2022,서울,질병,1,2,3
I30,2023,대구,질병,2,0,2
I30,2023,서울,질병,1,2,3
I31,2019,광주,질병,0,1,1
I31,2019,대구,질병,5,1,6
I31,2019,대전,질병,0,1,1
I31,2019,부산,질병,3,0,3
I31,2019,서울,질병,46,39,85
I31,2020,광주,질병,1,5,6
I31,2020,대구,질병,2,1,3
I31,2020,대전,질병,1,0,1
I31,2020,서울,질병,44,41,85
I31,2021,광주,질병,0,1,1
I31,2021,대구,질병,6,3,9
I31,2021,부산,질병,4,0,4
I31,2021,서울,질병,30,16,46
I31,2022,광주,질병,1,1,2
I31,2022,대구,질병,11,1,12
I31,2022,대전,질병,0,1,1
I31,2022,부산,질병,0,1,1
I31,2022,서울,질병,41,26,67
I31,2023,광주,질병,1,2,3
I31,2023,대구,질병,9,5,14
I31,2023,부산,질병,3,2,5
I31,2023,서울,질병,31,16,47
I31,2023,인천,질병,1,0,1
I32,2019,대구,질병,0,1,1
I32,2019,서울,질병,3,5,8
I32,2020,광주,질병,1,0,1
I32,2020,대구,질병,1,1,2
I32,2020,서울,질병,4,2,6
I32,2022,서울,질병,1,0,1
I32,2023,서울,질병,1,0,1
I33,2019,대구,질병,0,1,1
I33,2019,서울,질병,7,11,18
I33,2020,광주,질병,0,1,1
I33,2020,대구,질병,1,0,1
I33,2020,서울,질병,2,5,7
I33,2021,광주,질병,0,1,1
I33,2021,서울,질병,12,7,19
I33,2022,서울,질병,3,2,5
I33,2023,광주,질병,1,0,1
I33,2023,대구,질병,0,1,1
I33,2023,서울,질병,4,0,4
I34,2019,광주,질병,0,3,3
I34,2019,대구,질병,0,2,2
I34,2019,부산,질병,1,0,1
I34,2019,서울,질병,17,19,36
I34,2020,광주,질병,3,1,4
I34,2020,서울,질병,24,26,50
I34,2021,광주,질병,0,2,2
I34,2021,대구,질병,0,2,2
I34,2021,서울,질병,8,8,16
I34,2022,광주,질병,2,1,3
I34,2022,대구,질병,1,0,1
I34,2022,대전,질병,1,0,1
I34,2022,부산,질병,2,0,2
I34,2022,서울,질병,9,15,24
I34,2023,광주,질병,1,2,3
I34,2023,서울,질병,10,17,27
I35,2019,광주,질병,8,6,14
I35,2019,대구,질병,11,9,20
I35,2019,대전,질병,2,1,3
I35,2019,부산,질병,11,2,13
I35,2019,서울,질병,24,46,70
I35,2020,광주,질병,5,5,10
I35,2020,대구,질병,4,2,6
I35,2020,서울,질병,40,55,95
I35,2021,광주,질병,4,4,8
I35,2021,대구,질병,6,6,12
I35,2021,부산,질병,3,4,7
I35,2021,서울,질병,53,50,103
I35,2022,광주,질병,6,3,9
I35,2022,대구,질병,12,4,16
I35,2022,대전,질병,5,1,6
I35,2022,부산,질병,2,1,3
I35,2022,서울,질병,75,57,132
I35,2023,광주,질병,5,8,13
I35,2023,대구,질병,13,4,17
I35,2023,대전,질병,2,0,2
I35,2023,부산,질병,4,2,6
I35,2023,서울,질병,76,37,113
I36,2019,서울,질병,1,5,6
I36,2020,서울,질병,7,12,19
I36,2021,대구,질병,0,1,1
I36,2021,서울,질병,2,3,5
I36,2022,서울,질병,4,3,7
I36,2023,서울,질병,11,13,24
I37,2023,광주,질병,1,0,1
I38,2019,대전,질병,1,0,1
I38,2019,부산,질병,2,0,2
I38,2020,대구,질병,0,2,2
I38,2020,인천,질병,4,0,4
I38,2021,광주,질병,1,0,1
I38,2021,대구,질병,0,1,1
I38,2022,대구,질병,2,0,2
I38,2022,대전,질병,1,0,1
I38,2022,부산,질병,1,0,1
I38,2022,서울,질병,1,0,1
I38,2023,대전,질병,0,1,1
I38,2023,부산,질병,0,1,1
I39,2019,서울,질병,0,1,1
I39,2020,서울,질병,2,0,2
I40,2019,서울,질병,1,0,1
I40,2021,서울,질병,1,1,2
I40,2023,대구,질병,0,1,1
I40,2023,서울,질병,1,0,1
I42,2019,광주,질병,12,20,32
I42,2019,대구,질병,11,14,25
I42,2019,부산,질병,3,3,6
I42,2019,서울,질병,33,34,67
I42,2020,광주,질병,6,9,15
I42,2020,대구,질병,15,16,31
I42,2020,대전,질병,3,0,3
I42,2020,서울,질병,39,42,81
I42,2021,광주,질병,5,5,10
I42,2021,대구,질병,10,10,20
I42,2021,대전,질병,1,0,1
I42,2021,부산,질병,6,1,7
I42,2021,서울,질병,21,15,36
I42,2022,광주,질병,6,3,9
I42,2022,대구,질병,7,9,16
I42,2022,대전,질병,1,2,3
I42,2022,부산,질병,4,0,4
I42,2022,서울,질병,33,24,57
I42,2023,광주,질병,2,6,8
I42,2023,대구,질병,9,10,19
I42,2023,대전,질병,1,0,1
I42,2023,부산,질병,7,3,10
I42,2023,서울,질병,30,28,58
I43,2020,서울,질병,1,0,1
I43,2021,서울,질병,2,2,4
I43,2022,서울,질병,3,5,8
I43,2023,서울,질병,0,2,2
I44,2019,광주,질병,5,3,8
I44,2019,대구,질병,9,9,18
I44,2019,대전,질병,1,0,1
I44,2019,부산,질병,9,12,21
I44,2019,서울,질병,13,19,32
I44,2020,광주,질병,5,3,8
I44,2020,대구,질병,12,6,18
I44,2020,대전,질병,4,1,5
I44,2020,서울,질병,25,21,46
I44,2021,광주,질병,13,4,17
I44,2021,대구,질병,16,8,24
I44,2021,대전,질병,1,0,1
I44,2021,부산,질병,10,5,15
I44,2021,서울,질병,23,15,38
I44,2022,광주,질병,6,3,9
I44,2022,대구,질병,9,8,17
I44,2022,대전,질병,2,0,2
I44,2022,부산,질병,8,5,13
I44,2022,서울,질병,21,20,41
I44,2023,광주,질병,8,6,14
I44,2023,대구,질병,10,10,20
I44,2023,부산,질병,7,2,9
I44,2023,서울,질병,29,31,60
I45,2019,부산,질병,1,0,1
I45,2019,서울,질병,3,0,3
I45,2020,대구,질병,1,1,2
I45,2020,서울,질병,2,0,2
I45,2021,대전,질병,1,0,1
I45,2021,서울,질병,2,1,3
I45,2022,대구,질병,2,0,2
I45,2022,서울,질병,4,0,4
I45,2023,광주,질병,1,2,3
I45,2023,대구,질병,1,3,4
I45,2023,부산,질병,1,0,1
I45,2023,서울,질병,1,1,2
I46,2019,광주,질병,0,3,3
I46,2019,대구,질병,1,1,2
I46,2019,대전,질병,1,2,3
I46,2019,부산,질병,1,1,2
I46,2019,서울,질병,8,6,14
I46,2020,광주,질병,0,2,2
I46,2020,대구,질병,3,0,3
I46,2020,대전,질병,1,1,2
I46,2020,서울,질병,8,5,13
I46,2021,광주,질병,0,1,1
I46,2021,대구,질병,1,0,1
I46,2021,부산,질병,4,1,5
I46,2021,서울,질병,2,3,5
I46,2022,광주,질병,2,1,3
I46,2022,대구,질병,2,0,2
I46,2022,대전,질병,0,1,1
I46,2022,부산,질병,1,1,2
I46,2022,서울,질병,10,5,15
I46,2023,광주,질병,0,1,1
I46,2023,대구,질병,1,0,1
I46,2023,대전,질병,0,2,2
I46,2023,부산,질병,5,2,7
I46,2023,서울,질병,12,17,29
I47,2019,광주,질병,3,3,6
I47,2019,대구,질병,11,6,17
I47,2019,대전,질병,0,1,1
I47,2019,부산,질병,4,1,5
I47,2019,서울,질병,16,24,40
I47,2020,광주,질병,0,1,1
I47,2020,대구,질병,14,12,26
I47,2020,서울,질병,32,21,53
I47,2021,광주,질병,4,0,4
I47,2021,대구,질병,13,21,34
I47,2021,대전,질병,0,2,2
I47,2021,부산,질병,5,1,6
I47,2021,서울,질병,23,24,47
I47,2022,광주,질병,3,0,3
I47,2022,대구,질병,8,9,17
I47,2022,대전,질병,2,1,3
I47,2022,부산,질병,4,3,7
I47,2022,서울,질병,28,26,54
I47,2023,광주,질병,4,3,7
I47,2023,대구,질병,19,8,27
I47,2023,대전,질병,1,1,2
I47,2023,부산,질병,1,0,1
I47,2023,서울,질병,34,15,49
I48,2019,광주,질병,49,60,109
I48,2019,대구,질병,157,66,223
I48,2019,대전,질병,38,21,59
I48,2019,부산,질병,54,27,81
I48,2019,서울,질병,333,314,647
I48,2020,광주,질병,33,41,74
I48,2020,대구,질병,123,65,188
I48,2020,대전,질병,21,9,30
I48,2020,서울,질병,390,362,752
I48,2021,광주,질병,46,28,74
I48,2021,대구,질병,132,80,212
I48,2021,대전,질병,7,5,12
I48,2021,부산,질병,41,13,54
I48,2021,서울,질병,302,301,603
I48,2022,광주,질병,31,14,45
I48,2022,대구,질병,134,68,202
I48,2022,대전,질병,9,13,22
I48,2022,부산,질병,29,8,37
I48,2022,서울,질병,369,335,704
I48,2022,인천,질병,0,2,2
I48,2023,광주,질병,57,49,106
I48,2023,대구,질병,122,75,197
I48,2023,대전,질병,6,17,23
I48,2023,부산,질병,21,15,36
I48,2023,서울,질병,387,350,737
I48,2023,인천,질병,0,2,2
I49,2019,광주,질병,5,5,10
I49,2019,대구,질병,32,16,48
I49,2019,대전,질병,2,1,3
I49,2019,부산,질병,11,4,15
I49,2019,서울,질병,31,27,58
I49,2020,광주,질병,3,3,6
I49,2020,대구,질병,40,13,53
I49,2020,대전,질병,1,0,1
I49,2020,서울,질병,32,27,59
I49,2021,광주,질병,4,5,9
I49,2021,대구,질병,24,14,38
I49,2021,부산,질병,5,4,9
I49,2021,서울,질병,31,39,70
I49,2022,광주,질병,3,0,3
I49,2022,대구,질병,18,12,30
I49,2022,부산,질병,14,2,16
I49,2022,서울,질병,40,20,60
I49,2023,광주,질병,3,1,4
I49,2023,대구,질병,27,9,36
I49,2023,대전,질병,4,0,4
I49,2023,부산,질병,8,6,14
I49,2023,서울,질병,23,32,55
I50,2019,광주,질병,33,47,80
I50,2019,대구,질병,54,45,99
I50,2019,대전,질병,22,19,41
I50,2019,부산,질병,98,57,155
I50,2019,서울,질병,195,204,399
I50,2019,인천,질병,5,3,8
I50,2020,광주,질병,26,38,64
I50,2020,대구,질병,62,35,97
I50,2020,대전,질병,15,18,33
I50,2020,서울,질병,258,212,470
I50,2020,인천,질병,1,3,4
I50,2021,광주,질병,41,49,90
I50,2021,대구,질병,58,56,114
I50,2021,대전,질병,4,4,8
I50,2021,부산,질병,130,58,188
I50,2021,서울,질병,186,181,367
I50,2021,인천,질병,0,7,7
I50,2022,광주,질병,14,26,40
I50,2022,대구,질병,47,42,89
I50,2022,대전,질병,22,17,39
I50,2022,부산,질병,119,53,172
I50,2022,서울,질병,216,186,402
I50,2022,인천,질병,0,1,1
I50,2023,광주,질병,31,42,73
I50,2023,대구,질병,39,59,98
I50,2023,대전,질병,18,21,39
I50,2023,부산,질병,128,63,191
I50,2023,서울,질병,309,262,571
I50,2023,인천,질병,0,3,3
I51,2019,광주,질병,2,2,4
I51,2019,대전,질병,1,0,1
I51,2019,서울,질병,1,3,4
I51,2020,광주,질병,0,1,1
I51,2020,대구,질병,1,2,3
I51,2020,서울,질병,7,9,16
I51,2021,대구,질병,2,1,3
I51,2021,서울,질병,6,8,14
I51,2022,대구,질병,2,1,3
I51,2022,서울,질병,15,21,36
I51,2023,광주,질병,0,1,1
I51,2023,대구,질병,1,2,3
I51,2023,대전,질병,1,0,1
I51,2023,부산,질병,1,1,2
I51,2023,서울,질병,1,2,3
I60,2019,광주,질병,2,5,7
I60,2019,대구,질병,2,1,3
I60,2019,대전,질병,0,3,3
I60,2019,부산,질병,2,6,8
I60,2019,서울,질병,6,22,28
I60,2020,광주,질병,6,3,9
I60,2020,대구,질병,0,1,1
I60,2020,대전,질병,0,2,2
I60,2020,서울,질병,10,7,17
I60,2021,광주,질병,6,4,10
I60,2021,대구,질병,1,2,3
I60,2021,부산,질병,2,2,4
I60,2021,서울,질병,1,10,11
I60,2022,광주,질병,7,5,12
I60,2022,대구,질병,1,2,3
I60,2022,부산,질병,1,1,2
I60,2022,서울,질병,3,7,10
I60,2023,광주,질병,5,1,6
I60,2023,대구,질병,4,2,6
I60,2023,대전,질병,1,1,2
I60,2023,부산,질병,0,2,2
I60,2023,서울,질병,7,13,20
I61,2019,광주,질병,18,23,41
I61,2019,대구,질병,3,2,5
I61,2019,대전,질병,14,10,24
I61,2019,부산,질병,20,4,24
I61,2019,서울,질병,46,49,95
I61,2019,인천,질병,0,1,1
I61,2020,광주,질병,18,16,34
I61,2020,대구,질병,4,4,8
I61,2020,대전,질병,9,6,15
I61,2020,서울,질병,39,41,80
I61,2020,인천,질병,0,1,1
I61,2021,광주,질병,21,15,36
I61,2021,대구,질병,6,3,9
I61,2021,대전,질병,13,8,21
I61,2021,부산,질병,17,7,24
I61,2021,서울,질병,17,23,40
I61,2022,광주,질병,17,10,27
I61,2022,대구,질병,8,4,12
I61,2022,대전,질병,6,7,13
I61,2022,부산,질병,16,4,20
I61,2022,서울,질병,24,25,49
I61,2023,광주,질병,20,16,36
I61,2023,대구,질병,2,4,6
I61,2023,대전,질병,7,5,12
I61,2023,부산,질병,21,8,29
I61,2023,서울,질병,33,33,66
I61,2023,인천,질병,6,2,8
I62,2019,광주,질병,9,4,13
I62,2019,대구,질병,7,3,10
I62,2019,대전,질병,11,1,12
I62,2019,부산,질병,2,2,4
I62,2019,서울,질병,54,47,101
I62,2020,광주,질병,6,2,8
I62,2020,대구,질병,0,3,3
I62,2020,대전,질병,3,5,8
I62,2020,서울,질병,26,26,52
I62,2020,인천,질병,0,5,5
I62,2021,광주,질병,15,10,25
I62,2021,대구,질병,4,1,5
I62,2021,대전,질병,2,2,4
I62,2021,부산,질병,3,0,3
I62,2021,서울,질병,16,12,28
I62,2021,인천,질병,1,1,2
I62,2022,광주,질병,7,13,20
I62,2022,대구,질병,4,0,4
I62,2022,대전,질병,4,1,5
I62,2022,부산,질병,3,0,3
I62,2022,서울,질병,19,18,37
I62,2022,인천,질병,0,2,2
I62,2023,광주,질병,11,14,25
I62,2023,대구,질병,2,1,3
I62,2023,대전,질병,2,0,2
I62,2023,부산,질병,4,1,5
I62,2023,서울,질병,19,14,33
I62,2023,인천,질병,0,1,1
I63,2019,광주,질병,148,117,265
I63,2019,대구,질병,41,28,69
I63,2019,대전,질병,96,85,181
I63,2019,부산,질병,118,32,150
I63,2019,서울,질병,441,340,781
I63,2019,인천,질병,14,19,33
I63,2020,광주,질병,132,132,264
I63,2020,대구,질병,50,29,79
I63,2020,대전,질병,50,52,102
I63,2020,서울,질병,344,302,646
I63,2020,인천,질병,2,5,7
I63,2021,광주,질병,150,121,271
I63,2021,대구,질병,46,40,86
I63,2021,대전,질병,55,50,105
I63,2021,부산,질병,111,25,136
I63,2021,서울,질병,206,175,381
I63,2021,인천,질병,4,8,12
I63,2022,광주,질병,138,91,229
I63,2022,대구,질병,34,12,46
I63,2022,대전,질병,56,47,103
I63,2022,부산,질병,126,24,150
I63,2022,서울,질병,244,192,436
I63,2022,인천,질병,7,1,8
I63,2023,광주,질병,151,92,243
I63,2023,대구,질병,35,15,50
I63,2023,대전,질병,43,37,80
I63,2023,부산,질병,122,19,141
I63,2023,서울,질병,368,279,647
I63,2023,인천,질병,22,17,39
I64,2019,인천,질병,1,1,2
I64,2020,서울,질병,0,1,1
I64,2022,서울,질병,1,0,1
I65,2019,광주,질병,12,6,18
I65,2019,대구,질병,12,2,14
I65,2019,대전,질병,7,1,8
I65,2019,부산,질병,16,1,17
I65,2019,서울,질병,354,172,526
I65,2020,광주,질병,18,8,26
I65,2020,대구,질병,12,1,13
I65,2020,대전,질병,4,4,8
I65,2020,서울,질병,427,207,634
I65,2020,인천,질병,0,1,1
I65,2021,광주,질병,14,5,19
I65,2021,대구,질병,9,6,15
I65,2021,대전,질병,6,1,7
I65,2021,부산,질병,12,0,12
I65,2021,서울,질병,391,157,548
I65,2021,인천,질병,2,0,2
I65,2022,광주,질병,6,5,11
I65,2022,대구,질병,4,1,5
I65,2022,대전,질병,4,2,6
I65,2022,부산,질병,13,0,13
I65,2022,서울,질병,345,150,495
I65,2023,광주,질병,11,4,15
I65,2023,대구,질병,5,2,7
I65,2023,부산,질병,15,0,15
I65,2023,서울,질병,267,107,374
I65,2023,인천,질병,1,0,1
I66,2019,광주,질병,1,2,3
I66,2019,대구,질병,3,0,3
I66,2019,대전,질병,0,1,1
I66,2019,부산,질병,2,0,2
I66,2019,서울,질병,49,31,80
I66,2020,광주,질병,5,4,9
I66,2020,대구,질병,2,1,3
I66,2020,대전,질병,0,1,1
I66,2020,서울,질병,46,24,70
I66,2021,광주,질병,4,2,6
I66,2021,대구,질병,1,2,3
I66,2021,부산,질병,5,0,5
I66,2021,서울,질병,25,24,49
I66,2022,광주,질병,1,0,1
I66,2022,대구,질병,2,0,2
I66,2022,부산,질병,11,2,13
I66,2022,서울,질병,20,16,36
I66,2023,광주,질병,1,2,3
I66,2023,대구,질병,1,0,1
I66,2023,부산,질병,6,0,6
I66,2023,서울,질병,24,15,39
I67,2019,광주,질병,8,8,16
I67,2019,대구,질병,7,10,17
I67,2019,대전,질병,3,1,4
I67,2019,부산,질병,13,0,13
I67,2019,서울,질병,116,172,288
I67,2019,인천,질병,0,2,2
I67,2020,광주,질병,15,12,27
I67,2020,대구,질병,6,3,9
I67,2020,대전,질병,7,10,17
I67,2020,서울,질병,145,179,324
I67,2020,인천,질병,7,2,9
I67,2021,광주,질병,7,5,12
I67,2021,대구,질병,5,4,9
I67,2021,대전,질병,14,13,27
I67,2021,부산,질병,18,7,25
I67,2021,서울,질병,117,218,335
I67,2021,인천,질병,12,3,15
I67,2022,광주,질병,8,6,14
I67,2022,대구,질병,3,1,4
I67,2022,대전,질병,8,2,10
I67,2022,부산,질병,22,1,23
I67,2022,서울,질병,92,164,256
I67,2022,인천,질병,3,0,3
I67,2023,광주,질병,7,6,13
I67,2023,대구,질병,1,2,3
I67,2023,대전,질병,6,3,9
I67,2023,부산,질병,17,1,18
I67,2023,서울,질병,53,126,179
I67,2023,인천,질병,1,1,2
I68,2019,광주,질병,0,1,1
I68,2022,서울,질병,2,0,2
I69,2019,광주,질병,56,28,84
I69,2019,대구,질병,42,9,51
I69,2019,대전,질병,81,17,98
I69,2019,부산,질병,44,7,51
I69,2019,서울,질병,310,161,471
I69,2019,인천,질병,0,1,1
I69,2020,광주,질병,22,31,53
I69,2020,대구,질병,31,4,35
I69,2020,대전,질병,61,10,71
I69,2020,서울,질병,289,163,452
I69,2020,인천,질병,1,0,1
I69,2021,대구,질병,48,4,52
I69,2021,대전,질병,59,8,67
I69,2021,부산,질병,32,7,39
I69,2021,서울,질병,262,105,367
I69,2021,인천,질병,6,1,7
I69,2022,대구,질병,56,13,69
I69,2022,대전,질병,31,12,43
I69,2022,부산,질병,32,5,37
I69,2022,서울,질병,106,58,164
I69,2022,인천,질병,0,1,1
I69,2023,대구,질병,62,8,70
I69,2023,대전,질병,33,12,45
I69,2023,부산,질병,49,7,56
I69,2023,서울,질병,113,59,172
I70,2019,광주,질병,36,12,48
I70,2019,대구,질병,101,32,133
I70,2019,대전,질병,19,4,23
I70,2019,부산,질병,13,1,14
I70,2019,서울,질병,129,60,189
I70,2020,광주,질병,37,9,46
I70,2020,대구,질병,64,8,72
I70,2020,대전,질병,13,6,19
I70,2020,서울,질병,114,53,167
I70,2020,인천,질병,1,1,2
I70,2021,광주,질병,29,9,38
I70,2021,대구,질병,44,14,58
I70,2021,대전,질병,19,1,20
I70,2021,부산,질병,14,1,15
I70,2021,서울,질병,127,46,173
I70,2022,광주,질병,33,5,38
I70,2022,대구,질병,48,9,57
I70,2022,대전,질병,12,1,13
I70,2022,부산,질병,9,2,11
I70,2022,서울,질병,138,55,193
I70,2023,광주,질병,18,8,26
I70,2023,대구,질병,54,20,74
I70,2023,대전,질병,22,14,36
I70,2023,부산,질병,10,7,17
I70,2023,서울,질병,187,56,243
I71,2019,광주,질병,3,2,5
I71,2019,대구,질병,18,2,20
I71,2019,대전,질병,1,3,4
I71,2019,부산,질병,7,5,12
I71,2019,서울,질병,77,41,118
I71,2019,인천,질병,0,1,1
I71,2020,광주,질병,5,4,9
I71,2020,대구,질병,18,6,24
I71,2020,서울,질병,71,44,115
I71,2021,광주,질병,3,2,5
I71,2021,대구,질병,14,2,16
I71,2021,대전,질병,2,1,3
I71,2021,부산,질병,7,3,10
I71,2021,서울,질병,61,58,119
I71,2022,광주,질병,1,3,4
I71,2022,대구,질병,11,5,16
I71,2022,대전,질병,3,0,3
I71,2022,부산,질병,4,2,6
I71,2022,서울,질병,104,52,156
I71,2023,광주,질병,13,3,16
I71,2023,대구,질병,6,4,10
I71,2023,대전,질병,0,1,1
I71,2023,부산,질병,0,6,6
I71,2023,서울,질병,123,66,189
I71,2023,인천,질병,2,0,2
I72,2019,광주,질병,1,0,1
I72,2019,대구,질병,1,0,1
I72,2019,대전,질병,2,0,2
I72,2019,서울,질병,20,18,38
I72,2020,대전,질병,0,1,1
I72,2020,서울,질병,39,36,75
I72,2021,대구,질병,1,0,1
I72,2021,대전,질병,1,0,1
I72,2021,부산,질병,1,0,1
I72,2021,서울,질병,30,30,60
I72,2022,광주,질병,1,0,1
I72,2022,대구,질병,1,1,2
I72,2022,서울,질병,18,28,46
I72,2023,광주,질병,1,0,1
I72,2023,대전,질병,1,0,1
I72,2023,부산,질병,0,1,1
I72,2023,서울,질병,37,52,89
I73,2019,광주,질병,12,11,23
I73,2019,대구,질병,13,10,23
I73,2019,대전,질병,3,0,3
I73,2019,부산,질병,82,18,100
I73,2019,서울,질병,21,4,25
I73,2020,광주,질병,8,4,12
I73,2020,대구,질병,20,3,23
I73,2020,대전,질병,2,0,2
I73,2020,서울,질병,10,2,12
I73,2021,광주,질병,1,4,5
I73,2021,대구,질병,16,5,21
I73,2021,대전,질병,1,0,1
I73,2021,부산,질병,63,10,73
I73,2021,서울,질병,5,0,5
I73,2022,광주,질병,8,1,9
I73,2022,대구,질병,9,1,10
I73,2022,부산,질병,58,14,72
I73,2022,서울,질병,5,0,5
I73,2022,인천,질병,0,1,1
I73,2023,광주,질병,8,4,12
I73,2023,대구,질병,10,7,17
I73,2023,대전,질병,0,1,1
I73,2023,부산,질병,38,5,43
I73,2023,서울,질병,2,2,4
I74,2019,광주,질병,1,3,4
I74,2019,대구,질병,0,1,1
I74,2019,대전,질병,1,2,3
I74,2019,부산,질병,2,0,2
I74,2019,서울,질병,3,3,6
I74,2020,광주,질병,2,2,4
I74,2020,대구,질병,2,0,2
I74,2020,대전,질병,1,5,6
I74,2020,서울,질병,6,10,16
I74,2021,광주,질병,1,0,1
I74,2021,대구,질병,1,0,1
I74,2021,대전,질병,0,3,3
I74,2021,부산,질병,0,1,1
I74,2021,서울,질병,3,5,8
I74,2022,광주,질병,0,1,1
I74,2022,대구,질병,4,0,4
I74,2022,대전,질병,1,3,4
I74,2022,부산,질병,1,1,2
I74,2022,서울,질병,2,4,6
I74,2023,광주,질병,1,0,1
I74,2023,대구,질병,1,0,1
I74,2023,부산,질병,3,0,3
I74,2023,서울,질병,4,2,6
I77,2019,광주,질병,1,0,1
I77,2019,대구,질병,1,2,3
I77,2019,부산,질병,1,2,3
I77,2019,서울,질병,13,5,18
I77,2020,광주,질병,1,3,4
I77,2020,대구,질병,1,0,1
I77,2020,서울,질병,8,4,12
I77,2021,광주,질병,5,2,7
I77,2021,대구,질병,31,8,39
I77,2021,대전,질병,1,0,1
I77,2021,부산,질병,9,7,16
I77,2021,서울,질병,21,10,31
I77,2022,광주,질병,3,0,3
I77,2022,대구,질병,51,18,69
I77,2022,대전,질병,1,1,2
I77,2022,부산,질병,7,1,8
I77,2022,서울,질병,14,3,17
I77,2023,광주,질병,23,10,33
I77,2023,대구,질병,66,12,78
I77,2023,대전,질병,1,0,1
I77,2023,부산,질병,4,3,7
I77,2023,서울,질병,15,5,20
I78,2019,광주,질병,2,0,2
I78,2020,대전,질병,0,1,1
I78,2020,서울,질병,1,1,2
I78,2021,광주,질병,1,0,1
I78,2021,대전,질병,1,1,2
I78,2021,부산,질병,1,0,1
I78,2021,서울,질병,3,0,3
I78,2022,대전,질병,2,1,3
I78,2022,서울,질병,0,2,2
I78,2023,부산,질병,0,1,1
I78,2023,서울,질병,2,2,4
I79,2019,대구,질병,8,0,8
I79,2019,대전,질병,6,0,6
I79,2019,부산,질병,4,0,4
I79,2019,서울,질병,24,13,37
I79,2019,인천,질병,0,1,1
I79,2020,대구,질병,9,2,11
I79,2020,대전,질병,6,0,6
I79,2020,서울,질병,20,6,26
I79,2021,광주,질병,1,0,1
I79,2021,대구,질병,2,1,3
I79,2021,대전,질병,6,0,6
I79,2021,서울,질병,20,4,24
I79,2022,광주,질병,1,0,1
I79,2022,대구,질병,5,0,5
I79,2022,대전,질병,8,0,8
I79,2022,서울,질병,5,0,5
I79,2023,광주,질병,1,0,1
I79,2023,대구,질병,4,0,4
I79,2023,대전,질병,5,2,7
I79,2023,서울,질병,9,5,14
I80,2019,광주,질병,1,8,9
I80,2019,대구,질병,0,6,6
I80,2019,대전,질병,1,2,3
I80,2019,부산,질병,14,5,19
I80,2019,서울,질병,24,22,46
I80,2020,광주,질병,2,2,4
I80,2020,대구,질병,5,1,6
I80,2020,서울,질병,21,24,45
I80,2021,광주,질병,1,9,10
I80,2021,대구,질병,8,5,13
I80,2021,대전,질병,2,1,3
I80,2021,부산,질병,3,2,5
I80,2021,서울,질병,10,19,29
I80,2022,광주,질병,1,3,4
I80,2022,대구,질병,9,3,12
I80,2022,대전,질병,2,0,2
I80,2022,부산,질병,4,2,6
I80,2022,서울,질병,30,29,59
I80,2023,광주,질병,1,7,8
I80,2023,대구,질병,2,1,3
I80,2023,대전,질병,7,3,10
I80,2023,부산,질병,2,3,5
I80,2023,서울,질병,35,20,55
I81,2019,부산,질병,2,0,2
I81,2019,서울,질병,5,5,10
I81,2020,광주,질병,2,0,2
I81,2020,대전,질병,0,1,1
I81,2020,서울,질병,2,2,4
I81,2021,광주,질병,1,0,1
I81,2021,서울,질병,6,1,7
I81,2022,서울,질병,8,3,11
I81,2023,대전,질병,2,0,2
I81,2023,서울,질병,4,2,6
I82,2019,대구,질병,2,0,2
I82,2019,부산,질병,1,0,1
I82,2019,서울,질병,9,2,11
I82,2020,대전,질병,1,0,1
I82,2020,서울,질병,7,3,10
I82,2021,대전,질병,0,1,1
I82,2021,서울,질병,1,2,3
I82,2022,대구,질병,1,0,1
I82,2022,대전,질병,1,0,1
I82,2022,서울,질병,3,4,7
I82,2023,부산,질병,1,1,2
I82,2023,서울,질병,6,1,7
I83,2019,광주,질병,26,22,48
I83,2019,대구,질병,4,10,14
I83,2019,대전,질병,31,50,81
I83,2019,부산,질병,1,0,1
I83,2019,서울,질병,43,53,96
I83,2020,광주,질병,16,18,34
I83,2020,대구,질병,6,4,10
I83,2020,대전,질병,36,34,70
I83,2020,서울,질병,30,48,78
I83,2021,광주,질병,18,14,32
I83,2021,대구,질병,10,16,26
I83,2021,대전,질병,16,34,50
I83,2021,부산,질병,5,5,10
I83,2021,서울,질병,68,89,157
I83,2022,광주,질병,22,11,33
I83,2022,대구,질병,12,11,23
I83,2022,대전,질병,25,31,56
I83,2022,부산,질병,3,0,3
I83,2022,서울,질병,53,86,139
I83,2023,광주,질병,22,13,35
I83,2023,대구,질병,1,7,8
I83,2023,대전,질병,29,35,64
I83,2023,부산,질병,1,0,1
I83,2023,서울,질병,73,116,189
I83,2023,인천,질병,0,3,3
I85,2019,광주,질병,2,0,2
I85,2019,대구,질병,2,1,3
I85,2019,대전,질병,4,0,4
I85,2019,서울,질병,28,21,49
I85,2020,광주,질병,2,1,3
I85,2020,대구,질병,1,1,2
I85,2020,대전,질병,1,0,1
I85,2020,서울,질병,36,11,47
I85,2021,대구,질병,1,0,1
I85,2021,서울,질병,9,8,17
I85,2022,대구,질병,4,1,5
I85,2022,서울,질병,3,2,5
I85,2023,대구,질병,1,0,1
I85,2023,대전,질병,1,0,1
I85,2023,서울,질병,4,5,9
I86,2019,광주,질병,0,1,1
I86,2019,대구,질병,2,1,3
I86,2019,대전,질병,3,2,5
I86,2019,부산,질병,1,1,2
I86,2019,서울,질병,20,10,30
I86,2019,인천,질병,11,35,46
I86,2020,대구,질병,1,0,1
I86,2020,대전,질병,2,0,2
I86,2020,서울,질병,19,7,26
I86,2020,인천,질병,2,1,3
I86,2021,광주,질병,1,1,2
I86,2021,대구,질병,1,0,1
I86,2021,대전,질병,4,0,4
I86,2021,부산,질병,6,2,8
I86,2021,서울,질병,10,8,18
I86,2022,광주,질병,0,7,7
I86,2022,대전,질병,5,3,8
I86,2022,부산,질병,16,0,16
I86,2022,서울,질병,9,10,19
I86,2023,광주,질병,0,5,5
I86,2023,대전,질병,1,2,3
I86,2023,부산,질병,5,1,6
I86,2023,서울,질병,4,3,7
I87,2019,대구,질병,1,0,1
I87,2019,대전,질병,1,0,1
I87,2019,부산,질병,3,0,3
I87,2019,서울,질병,11,20,31
I87,2020,광주,질병,7,0,7
I87,2020,대구,질병,4,1,5
I87,2020,서울,질병,13,8,21
I87,2021,광주,질병,1,1,2
I87,2021,대구,질병,1,1,2
I87,2021,서울,질병,6,10,16
I87,2022,광주,질병,0,1,1
I87,2022,대구,질병,5,0,5
I87,2022,부산,질병,2,0,2
I87,2022,서울,질병,3,2,5
I87,2023,광주,질병,1,0,1
I87,2023,대구,질병,4,0,4
I87,2023,대전,질병,1,0,1
I87,2023,부산,질병,1,0,1
I87,2023,서울,질병,4,4,8
I88,2019,광주,질병,0,1,1
I88,2019,대구,질병,1,2,3
I88,2019,대전,질병,2,2,4
I88,2020,광주,질병,2,0,2
I88,2020,대구,질병,1,0,1
I88,2020,대전,질병,2,1,3
I88,2020,서울,질병,4,0,4
I88,2021,대전,질병,1,2,3
I88,2021,서울,질병,1,1,2
I88,2022,대구,질병,2,0,2
I88,2022,서울,질병,1,2,3
I88,2023,서울,질병,1,1,2
I89,2019,광주,질병,0,1,1
I89,2019,대구,질병,0,1,1
I89,2019,대전,질병,15,3,18
I89,2019,부산,질병,1,0,1
I89,2019,서울,질병,6,6,12
I89,2020,광주,질병,2,0,2
I89,2020,대구,질병,0,1,1
I89,2020,대전,질병,17,1,18
I89,2020,서울,질병,4,11,15
I89,2021,광주,질병,1,0,1
I89,2021,대전,질병,13,3,16
I89,2021,부산,질병,2,0,2
I89,2021,서울,질병,2,1,3
I89,2021,인천,질병,2,3,5
I89,2022,대전,질병,13,0,13
I89,2022,서울,질병,9,8,17
I89,2023,광주,질병,1,0,1
I89,2023,대전,질병,15,1,16
I89,2023,서울,질병,9,7,16
I95,2019,광주,질병,5,4,9
I95,2019,대구,질병,12,3,15
I95,2019,대전,질병,4,1,5
I95,2019,부산,질병,6,0,6
I95,2019,서울,질병,45,26,71
I95,2020,광주,질병,4,0,4
I95,2020,대구,질병,8,2,10
I95,2020,대전,질병,10,4,14
I95,2020,서울,질병,37,21,58
I95,2021,광주,질병,5,1,6
I95,2021,대구,질병,9,2,11
I95,2021,대전,질병,4,0,4
I95,2021,부산,질병,12,0,12
I95,2021,서울,질병,28,20,48
I95,2021,인천,질병,0,1,1
I95,2022,광주,질병,2,0,2
I95,2022,대구,질병,13,1,14
I95,2022,대전,질병,3,3,6
I95,2022,부산,질병,7,1,8
I95,2022,서울,질병,42,31,73
I95,2023,광주,질병,6,4,10
I95,2023,대구,질병,9,2,11
I95,2023,대전,질병,5,2,7
I95,2023,부산,질병,5,0,5
I95,2023,서울,질병,78,37,115
I97,2019,서울,질병,4,3,7
I97,2020,서울,질병,2,13,15
I97,2021,서울,질병,10,5,15
I97,2022,대전,질병,1,0,1
I97,2022,서울,질병,6,9,15
I97,2023,서울,질병,7,3,10
I98,2019,대구,질병,3,0,3
I98,2019,대전,질병,1,0,1
I98,2019,서울,질병,15,6,21
I98,2020,대구,질병,1,0,1
I98,2020,서울,질병,21,8,29
I98,2021,광주,질병,2,1,3
I98,2021,서울,질병,38,16,54
I98,2022,광주,질병,1,1,2
I98,2022,대구,질병,1,0,1
I98,2022,서울,질병,20,10,30
I98,2023,광주,질병,8,1,9
I98,2023,서울,질병,25,12,37
I99,2019,대구,질병,1,0,1
I99,2021,부산,질병,1,0,1
I99,2021,서울,질병,0,1,1
I99,2022,대전,질병,1,0,1
I99,2023,대구,질병,0,2,2
I99,2023,대전,질병,1,0,1
I99,2023,서울,질병,2,1,3
J00,2019,광주,질병,1,1,2
J00,2019,대구,질병,9,1,10
J00,2019,대전,질병,4,3,7
J00,2019,부산,질병,16,2,18
J00,2019,서울,질병,6,7,13
J00,2019,인천,질병,0,3,3
J00,2020,광주,질병,0,1,1
J00,2020,대전,질병,0,1,1
J00,2020,인천,질병,1,2,3
J00,2021,대구,질병,2,1,3
J00,2021,대전,질병,1,1,2
J00,2021,부산,질병,12,1,13
J00,2022,대구,질병,5,0,5
J00,2022,대전,질병,1,0,1
J00,2022,부산,질병,3,0,3
J00,2023,광주,질병,1,0,1
J00,2023,대구,질병,6,3,9
J00,2023,대전,질병,1,0,1
J00,2023,부산,질병,2,2,4
J00,2023,서울,질병,3,3,6
J01,2019,광주,질병,1,9,10
J01,2019,대구,질병,0,1,1
J01,2019,대전,질병,1,0,1
J01,2019,서울,질병,0,3,3
J01,2019,인천,질병,1,0,1
J01,2020,광주,질병,0,2,2
J01,2020,대전,질병,7,1,8
J01,2020,서울,질병,0,2,2
J01,2020,인천,질병,1,0,1
J01,2021,광주,질병,1,0,1
J01,2021,대전,질병,0,1,1
J01,2021,서울,질병,0,1,1
J01,2022,광주,질병,1,0,1
J01,2022,서울,질병,3,0,3
J01,2023,대전,질병,2,0,2
J01,2023,서울,질병,2,5,7
J02,2019,광주,질병,0,51,51
J02,2019,대구,질병,1,1,2
J02,2019,대전,질병,3,3,6
J02,2019,부산,질병,1,0,1
J02,2019,서울,질병,5,4,9
J02,2019,인천,질병,1,1,2
J02,2020,대구,질병,1,0,1
J02,2020,대전,질병,1,0,1
J02,2020,서울,질병,8,1,9
J02,2020,인천,질병,0,2,2
J02,2021,대전,질병,1,1,2
J02,2021,부산,질병,1,0,1
J02,2021,서울,질병,2,3,5
J02,2022,광주,질병,0,2,2
J02,2022,대구,질병,1,0,1
J02,2022,대전,질병,3,0,3
J02,2023,대전,질병,3,7,10
J02,2023,서울,질병,1,2,3
J03,2019,광주,질병,0,73,73
J03,2019,대구,질병,2,1,3
J03,2019,대전,질병,1,4,5
J03,2019,부산,질병,0,2,2
J03,2019,서울,질병,1,2,3
J03,2019,인천,질병,1,3,4
J03,2020,광주,질병,0,13,13
J03,2020,대구,질병,0,2,2
J03,2020,대전,질병,1,1,2
J03,2020,서울,질병,2,2,4
J03,2021,광주,질병,0,2,2
J03,2021,대구,질병,0,1,1
J03,2021,대전,질병,0,3,3
J03,2021,서울,질병,1,1,2
J03,2021,인천,질병,0,1,1
J03,2022,광주,질병,0,1,1
J03,2022,대전,질병,0,1,1
J03,2023,광주,질병,0,2,2
J03,2023,대전,질병,0,1,1
J03,2023,부산,질병,0,1,1
J03,2023,서울,질병,0,3,3
J04,2019,광주,질병,2,0,2
J04,2019,대전,질병,1,0,1
J04,2019,부산,질병,2,0,2
J04,2019,서울,질병,5,3,8
J04,2019,인천,질병,1,3,4
J04,2020,서울,질병,5,2,7
J04,2020,인천,질병,0,1,1
J04,2021,대구,질병,1,0,1
J04,2021,부산,질병,5,0,5
J04,2021,서울,질병,3,1,4
J04,2022,대구,질병,3,0,3
J04,2022,서울,질병,8,3,11
J04,2023,서울,질병,10,6,16
J05,2019,광주,질병,0,10,10
J05,2019,부산,질병,2,0,2
J05,2019,서울,질병,3,3,6
J05,2020,광주,질병,0,1,1
J05,2020,서울,질병,3,1,4
J05,2020,인천,질병,0,1,1
J05,2021,대구,질병,1,1,2
J05,2021,부산,질병,1,1,2
J05,2021,서울,질병,2,0,2
J05,2022,대전,질병,1,1,2
J05,2022,부산,질병,0,1,1
J05,2022,서울,질병,0,3,3
J05,2023,대전,질병,0,1,1
J05,2023,서울,질병,2,0,2
J06,2019,광주,질병,0,2,2
J06,2019,대구,질병,6,0,6
J06,2019,대전,질병,5,5,10
J06,2019,부산,질병,3,0,3
J06,2019,서울,질병,8,2,10
J06,2020,대구,질병,2,2,4
J06,2020,대전,질병,5,1,6
J06,2020,서울,질병,1,6,7
J06,2020,인천,질병,1,0,1
J06,2021,대전,질병,3,0,3
J06,2021,부산,질병,1,0,1
J06,2021,서울,질병,0,2,2
J06,2022,광주,질병,1,0,1
J06,2022,대구,질병,3,0,3
J06,2022,대전,질병,3,1,4
J06,2022,서울,질병,1,3,4
J06,2023,광주,질병,0,1,1
J06,2023,대구,질병,0,1,1
J06,2023,대전,질병,1,0,1
J06,2023,부산,질병,0,1,1
J06,2023,서울,질병,4,4,8
J06,2023,인천,질병,1,1,2
J09,2019,광주,질병,1,135,136
J09,2019,대전,질병,5,2,7
J09,2019,서울,질병,7,1,8
J09,2020,광주,질병,4,6,10
J09,2020,서울,질병,2,0,2
J09,2022,광주,질병,1,0,1
J09,2023,광주,질병,2,0,2
J10,2019,광주,질병,0,2,2
J10,2019,대구,질병,25,12,37
J10,2019,대전,질병,2,1,3
J10,2019,서울,질병,19,12,31
J10,2019,인천,질병,1,0,1
J10,2020,대구,질병,10,9,19
J10,2020,대전,질병,7,4,11
J10,2020,서울,질병,6,6,12
J10,2020,인천,질병,2,1,3
J10,2022,서울,질병,1,0,1
J10,2023,대구,질병,5,6,11
J10,2023,대전,질병,4,0,4
J10,2023,서울,질병,6,1,7
J10,2023,인천,질병,0,1,1
J11,2019,광주,질병,2,120,122
J11,2019,대전,질병,2,0,2
J11,2019,부산,질병,1,0,1
J11,2019,서울,질병,3,1,4
J11,2020,광주,질병,1,20,21
J11,2020,대전,질병,0,1,1
J11,2020,인천,질병,0,1,1
J11,2022,광주,질병,0,1,1
J11,2022,부산,질병,0,2,2
J11,2023,광주,질병,5,3,8
J11,2023,대구,질병,2,0,2
J11,2023,대전,질병,1,2,3
J11,2023,부산,질병,3,1,4
J11,2023,서울,질병,0,3,3
J12,2019,광주,질병,0,21,21
J12,2019,부산,질병,1,0,1
J12,2019,서울,질병,2,0,2
J12,2019,인천,질병,0,1,1
J12,2020,광주,질병,1,0,1
J12,2020,대구,질병,1,44,45
J12,2020,대전,질병,1,0,1
J12,2020,서울,질병,1,25,26
J12,2020,인천,질병,2,0,2
J12,2021,대전,질병,1,1,2
J12,2021,서울,질병,13,1241,1254
J12,2022,광주,질병,1,1,2
J12,2022,대구,질병,24,36,60
J12,2022,부산,질병,1,1,2
J12,2022,서울,질병,56,248,304
J12,2023,광주,질병,1,3,4
J12,2023,대구,질병,10,10,20
J12,2023,대전,질병,1,0,1
J12,2023,서울,질병,61,48,109
J13,2019,대구,질병,0,1,1
J13,2019,서울,질병,3,2,5
J13,2020,서울,질병,0,1,1
J13,2021,서울,질병,0,1,1
J13,2022,서울,질병,1,0,1
J13,2023,대구,질병,0,6,6
J13,2023,서울,질병,2,0,2
J14,2019,대구,질병,2,0,2
J14,2019,서울,질병,1,2,3
J14,2020,서울,질병,0,1,1
J14,2021,서울,질병,0,1,1
J14,2022,서울,질병,0,1,1
J14,2023,대구,질병,0,3,3
J14,2023,서울,질병,1,2,3
J15,2019,광주,질병,7,108,115
J15,2019,대구,질병,24,29,53
J15,2019,대전,질병,15,6,21
J15,2019,서울,질병,188,187,375
J15,2019,인천,질병,4,8,12
J15,2020,광주,질병,6,20,26
J15,2020,대구,질병,18,3,21
J15,2020,대전,질병,12,5,17
J15,2020,서울,질병,307,192,499
J15,2020,인천,질병,2,4,6
J15,2021,광주,질병,3,6,9
J15,2021,대구,질병,3,1,4
J15,2021,대전,질병,16,5,21
J15,2021,부산,질병,1,1,2
J15,2021,서울,질병,237,148,385
J15,2021,인천,질병,1,5,6
J15,2022,광주,질병,9,4,13
J15,2022,대구,질병,24,6,30
J15,2022,대전,질병,17,12,29
J15,2022,부산,질병,3,2,5
J15,2022,서울,질병,277,180,457
J15,2023,광주,질병,8,10,18
J15,2023,대구,질병,25,34,59
J15,2023,대전,질병,15,6,21
J15,2023,부산,질병,3,1,4
J15,2023,서울,질병,326,244,570
J15,2023,인천,질병,0,1,1
J16,2019,광주,질병,0,1,1
J16,2019,대구,질병,0,1,1
J16,2020,광주,질병,2,0,2
J16,2020,대구,질병,0,2,2
J16,2021,광주,질병,2,0,2
J16,2022,부산,질병,1,0,1
J16,2023,광주,질병,0,1,1
J17,2019,대전,질병,1,0,1
J17,2019,서울,질병,1,0,1
J17,2020,대구,질병,1,0,1
J17,2020,서울,질병,3,2,5
J17,2021,서울,질병,6,3,9
J17,2022,광주,질병,1,0,1
J17,2022,서울,질병,9,9,18
J17,2023,서울,질병,11,3,14
J18,2019,광주,질병,133,242,375
J18,2019,대구,질병,132,98,230
J18,2019,대전,질병,193,163,356
J18,2019,부산,질병,250,110,360
J18,2019,서울,질병,456,387,843
J18,2019,인천,질병,4,15,19
J18,2020,광주,질병,64,110,174
J18,2020,대구,질병,114,68,182
J18,2020,대전,질병,113,107,220
J18,2020,서울,질병,357,309,666
J18,2020,인천,질병,5,19,24
J18,2021,광주,질병,63,51,114
J18,2021,대구,질병,107,119,226
J18,2021,대전,질병,83,85,168
J18,2021,부산,질병,97,31,128
J18,2021,서울,질병,213,212,425
J18,2021,인천,질병,3,9,12
J18,2022,광주,질병,27,19,46
J18,2022,대구,질병,118,74,192
J18,2022,대전,질병,82,62,144
J18,2022,부산,질병,136,60,196
J18,2022,서울,질병,261,239,500
J18,2022,인천,질병,0,3,3
J18,2023,광주,질병,37,43,80
J18,2023,대구,질병,131,61,192
J18,2023,대전,질병,87,64,151
J18,2023,부산,질병,208,81,289
J18,2023,서울,질병,360,300,660
J18,2023,인천,질병,10,33,43
J19,2019,서울,질병,0,1,1
J20,2019,광주,질병,0,54,54
J20,2019,대구,질병,10,8,18
J20,2019,대전,질병,9,9,18
J20,2019,부산,질병,5,3,8
J20,2019,인천,질병,0,4,4
J20,2020,광주,질병,0,8,8
J20,2020,대구,질병,8,6,14
J20,2020,대전,질병,2,2,4
J20,2020,인천,질병,3,2,5
J20,2021,광주,질병,0,2,2
J20,2021,대구,질병,1,2,3
J20,2021,대전,질병,1,2,3
J20,2021,부산,질병,2,1,3
J20,2021,서울,질병,1,10,11
J20,2022,광주,질병,0,1,1
J20,2022,대구,질병,7,1,8
J20,2022,대전,질병,1,2,3
J20,2022,부산,질병,2,0,2
J20,2022,서울,질병,1,0,1
J20,2023,광주,질병,1,0,1
J20,2023,대구,질병,10,2,12
J20,2023,대전,질병,2,1,3
J20,2023,부산,질병,2,0,2
J20,2023,서울,질병,2,3,5
J20,2023,인천,질병,1,0,1
J21,2019,광주,질병,3,101,104
J21,2019,대구,질병,1,0,1
J21,2019,대전,질병,2,1,3
J21,2019,서울,질병,5,10,15
J21,2020,광주,질병,0,10,10
J21,2020,대구,질병,1,1,2
J21,2020,대전,질병,2,0,2
J21,2020,서울,질병,9,7,16
J21,2020,인천,질병,2,8,10
J21,2021,대구,질병,2,2,4
J21,2021,대전,질병,1,2,3
J21,2021,서울,질병,2,20,22
J21,2021,인천,질병,10,31,41
J21,2022,광주,질병,0,1,1
J21,2022,대구,질병,3,1,4
J21,2022,대전,질병,1,4,5
J21,2022,서울,질병,3,1,4
J21,2022,인천,질병,0,2,2
J21,2023,광주,질병,2,1,3
J21,2023,대구,질병,1,1,2
J21,2023,대전,질병,11,2,13
J21,2023,서울,질병,5,4,9
J22,2021,서울,질병,0,2,2
J30,2019,광주,질병,2,2,4
J30,2019,대구,질병,14,3,17
J30,2019,대전,질병,21,5,26
J30,2019,부산,질병,14,12,26
J30,2019,서울,질병,19,9,28
J30,2020,광주,질병,1,0,1
J30,2020,대구,질병,3,1,4
J30,2020,대전,질병,17,0,17
J30,2020,서울,질병,15,7,22
J30,2020,인천,질병,0,1,1
J30,2021,대구,질병,5,3,8
J30,2021,대전,질병,17,0,17
J30,2021,부산,질병,14,7,21
J30,2021,서울,질병,11,14,25
J30,2022,대구,질병,18,1,19
J30,2022,대전,질병,10,0,10
J30,2022,부산,질병,1,0,1
J30,2022,서울,질병,15,8,23
J30,2023,광주,질병,6,0,6
J30,2023,대구,질병,12,2,14
J30,2023,대전,질병,5,1,6
J30,2023,부산,질병,2,1,3
J30,2023,서울,질병,26,17,43
J31,2019,대구,질병,1,0,1
J31,2019,대전,질병,1,0,1
J31,2019,부산,질병,2,0,2
J31,2019,서울,질병,23,17,40
J31,2019,인천,질병,2,3,5
J31,2020,대전,질병,2,1,3
J31,2020,서울,질병,11,14,25
J31,2020,인천,질병,14,18,32
J31,2021,대전,질병,1,0,1
J31,2021,부산,질병,1,0,1
J31,2021,서울,질병,7,5,12
J31,2021,인천,질병,5,4,9
J31,2022,대전,질병,1,0,1
J31,2022,서울,질병,3,0,3
J31,2023,광주,질병,28,8,36
J31,2023,대전,질병,1,0,1
J31,2023,부산,질병,1,0,1
J31,2023,서울,질병,5,4,9
J31,2023,인천,질병,3,5,8
J32,2019,광주,질병,0,3,3
J32,2019,대구,질병,3,1,4
J32,2019,대전,질병,29,23,52
J32,2019,부산,질병,11,5,16
J32,2019,서울,질병,95,69,164
J32,2019,인천,질병,3,1,4
J32,2020,광주,질병,0,2,2
J32,2020,대구,질병,3,2,5
J32,2020,대전,질병,17,10,27
J32,2020,서울,질병,84,60,144
J32,2020,인천,질병,3,4,7
J32,2021,광주,질병,0,1,1
J32,2021,대구,질병,1,4,5
J32,2021,대전,질병,4,6,10
J32,2021,부산,질병,15,4,19
J32,2021,서울,질병,62,60,122
J32,2021,인천,질병,3,3,6
J32,2022,광주,질병,1,1,2
J32,2022,대구,질병,1,0,1
J32,2022,대전,질병,6,5,11
J32,2022,부산,질병,5,3,8
J32,2022,서울,질병,61,55,116
J32,2023,광주,질병,10,8,18
J32,2023,대구,질병,1,0,1
J32,2023,대전,질병,14,11,25
J32,2023,부산,질병,4,2,6
J32,2023,서울,질병,67,58,125
J32,2023,인천,질병,2,3,5
J33,2019,대구,질병,3,4,7
J33,2019,대전,질병,1,0,1
J33,2019,부산,질병,6,4,10
J33,2019,서울,질병,18,17,35
J33,2019,인천,질병,0,9,9
J33,2020,대구,질병,2,3,5
J33,2020,대전,질병,0,1,1
J33,2020,서울,질병,16,17,33
J33,2020,인천,질병,1,0,1
J33,2021,대구,질병,1,2,3
J33,2021,부산,질병,11,4,15
J33,2021,서울,질병,14,25,39
J33,2022,부산,질병,2,2,4
J33,2022,서울,질병,13,18,31
J33,2023,대전,질병,1,1,2
J33,2023,부산,질병,3,2,5
J33,2023,서울,질병,13,12,25
J33,2023,인천,질병,0,1,1
J34,2019,광주,질병,12,0,12
J34,2019,대구,질병,0,4,4
J34,2019,대전,질병,20,3,23
J34,2019,부산,질병,33,20,53
J34,2019,서울,질병,73,66,139
J34,2019,인천,질병,8,2,10
J34,2020,광주,질병,0,1,1
J34,2020,대구,질병,2,0,2
J34,2020,대전,질병,12,2,14
J34,2020,서울,질병,54,46,100
J34,2020,인천,질병,3,6,9
J34,2021,대구,질병,3,0,3
J34,2021,대전,질병,7,1,8
J34,2021,부산,질병,29,9,38
J34,2021,서울,질병,48,51,99
J34,2021,인천,질병,7,2,9
J34,2022,대전,질병,1,4,5
J34,2022,부산,질병,11,4,15
J34,2022,서울,질병,45,36,81
J34,2023,광주,질병,8,1,9
J34,2023,대전,질병,9,5,14
J34,2023,부산,질병,7,7,14
J34,2023,서울,질병,42,28,70
J34,2023,인천,질병,3,4,7
J35,2019,대구,질병,0,1,1
J35,2019,대전,질병,1,1,2
J35,2019,서울,질병,7,7,14
J35,2020,대구,질병,1,1,2
J35,2020,대전,질병,0,1,1
J35,2020,서울,질병,13,3,16
J35,2021,대구,질병,0,1,1
J35,2021,대전,질병,1,1,2
J35,2021,서울,질병,10,2,12
J35,2022,대전,질병,0,2,2
J35,2022,서울,질병,6,4,10
J35,2023,서울,질병,8,4,12
J35,2023,인천,질병,0,1,1
J36,2019,광주,질병,1,0,1
J36,2019,대구,질병,1,0,1
J36,2019,대전,질병,0,1,1
J36,2019,부산,질병,1,1,2
J36,2019,서울,질병,2,1,3
J36,2020,대전,질병,1,1,2
J36,2020,서울,질병,5,0,5
J36,2020,인천,질병,0,3,3
J36,2021,광주,질병,0,1,1
J36,2021,대전,질병,2,1,3
J36,2021,부산,질병,1,0,1
J36,2021,서울,질병,1,1,2
J36,2022,대전,질병,0,1,1
J36,2022,부산,질병,2,0,2
J36,2022,서울,질병,4,8,12
J36,2023,대전,질병,1,0,1
J36,2023,서울,질병,3,3,6
J36,2023,인천,질병,0,1,1
J37,2019,대전,질병,2,0,2
J37,2019,부산,질병,1,3,4
J37,2019,서울,질병,9,5,14
J37,2019,인천,질병,1,0,1
J37,2020,서울,질병,16,7,23
J37,2020,인천,질병,1,1,2
J37,2021,서울,질병,7,4,11
J37,2022,부산,질병,0,1,1
J37,2022,서울,질병,6,3,9
J37,2023,대전,질병,1,0,1
J37,2023,서울,질병,15,2,17
J37,2023,인천,질병,1,0,1
J38,2019,광주,질병,1,0,1
J38,2019,대전,질병,7,2,9
J38,2019,서울,질병,66,32,98
J38,2020,대구,질병,0,1,1
J38,2020,대전,질병,10,4,14
J38,2020,서울,질병,86,43,129
J38,2021,대전,질병,10,1,11
J38,2021,서울,질병,60,40,100
J38,2022,대전,질병,7,0,7
J38,2022,부산,질병,1,0,1
J38,2022,서울,질병,75,50,125
J38,2023,대전,질병,5,2,7
J38,2023,부산,질병,1,0,1
J38,2023,서울,질병,71,41,112
J39,2019,광주,질병,0,1,1
J39,2019,대전,질병,2,0,2
J39,2019,서울,질병,19,6,25
J39,2020,광주,질병,2,1,3
J39,2020,대전,질병,2,0,2
J39,2020,서울,질병,8,8,16
J39,2021,광주,질병,1,0,1
J39,2021,대구,질병,0,1,1
J39,2021,서울,질병,10,6,16
J39,2022,광주,질병,0,1,1
J39,2022,대구,질병,1,0,1
J39,2022,서울,질병,6,6,12
J39,2023,대전,질병,1,0,1
J39,2023,서울,질병,4,3,7
J40,2019,광주,질병,3,4,7
J40,2019,대구,질병,13,2,15
J40,2019,대전,질병,9,5,14
J40,2019,부산,질병,8,3,11
J40,2019,서울,질병,4,6,10
J40,2019,인천,질병,1,2,3
J40,2020,광주,질병,2,0,2
J40,2020,대구,질병,5,1,6
J40,2020,대전,질병,9,1,10
J40,2020,서울,질병,6,3,9
J40,2020,인천,질병,1,0,1
J40,2021,광주,질병,6,2,8
J40,2021,대구,질병,4,6,10
J40,2021,대전,질병,0,1,1
J40,2021,부산,질병,8,1,9
J40,2021,서울,질병,2,4,6
J40,2022,대구,질병,12,3,15
J40,2022,대전,질병,2,1,3
J40,2022,부산,질병,8,2,10
J40,2022,서울,질병,1,2,3
J40,2023,광주,질병,1,1,2
J40,2023,대구,질병,8,0,8
J40,2023,대전,질병,0,3,3
J40,2023,부산,질병,2,3,5
J40,2023,서울,질병,9,1,10
J40,2023,인천,질병,0,9,9
J41,2019,대구,질병,2,0,2
J41,2019,대전,질병,3,3,6
J41,2019,인천,질병,0,1,1
J41,2020,대구,질병,3,0,3
J41,2020,대전,질병,3,0,3
J41,2020,서울,질병,1,0,1
J41,2021,대구,질병,2,0,2
J41,2021,대전,질병,2,1,3
J41,2021,인천,질병,0,1,1
J41,2022,대구,질병,7,0,7
J41,2022,대전,질병,2,0,2
J41,2022,인천,질병,0,1,1
J41,2023,대구,질병,2,0,2
J41,2023,대전,질병,2,0,2
J42,2019,광주,질병,0,2,2
J42,2019,대구,질병,10,5,15
J42,2019,대전,질병,2,0,2
J42,2019,서울,질병,7,4,11
J42,2020,광주,질병,1,1,2
J42,2020,대구,질병,16,6,22
J42,2020,대전,질병,2,1,3
J42,2020,서울,질병,3,3,6
J42,2021,광주,질병,0,2,2
J42,2021,대구,질병,5,2,7
J42,2021,대전,질병,3,0,3
J42,2021,부산,질병,0,1,1
J42,2021,서울,질병,5,3,8
J42,2022,대구,질병,6,2,8
J42,2022,대전,질병,7,2,9
J42,2022,부산,질병,1,0,1
J42,2022,서울,질병,5,3,8
J42,2023,광주,질병,0,1,1
J42,2023,대구,질병,8,5,13
J42,2023,대전,질병,32,1,33
J42,2023,부산,질병,1,2,3
J42,2023,서울,질병,5,6,11
J43,2019,광주,질병,1,1,2
J43,2019,부산,질병,2,0,2
J43,2019,서울,질병,50,49,99
J43,2020,광주,질병,1,0,1
J43,2020,서울,질병,72,65,137
J43,2020,인천,질병,0,1,1
J43,2021,광주,질병,3,0,3
J43,2021,부산,질병,7,0,7
J43,2021,서울,질병,35,32,67
J43,2022,대구,질병,1,0,1
J43,2022,부산,질병,2,1,3
J43,2022,서울,질병,27,19,46
J43,2023,대전,질병,1,0,1
J43,2023,부산,질병,1,1,2
J43,2023,서울,질병,38,27,65
J44,2019,광주,질병,70,63,133
J44,2019,대구,질병,75,28,103
J44,2019,대전,질병,73,48,121
J44,2019,부산,질병,19,5,24
J44,2019,서울,질병,459,262,721
J44,2019,인천,질병,7,20,27
J44,2020,광주,질병,52,36,88
J44,2020,대구,질병,76,15,91
J44,2020,대전,질병,43,23,66
J44,2020,서울,질병,449,243,692
J44,2020,인천,질병,3,27,30
J44,2021,광주,질병,52,39,91
J44,2021,대구,질병,51,19,70
J44,2021,대전,질병,34,13,47
J44,2021,부산,질병,17,9,26
J44,2021,서울,질병,363,206,569
J44,2021,인천,질병,18,35,53
J44,2022,광주,질병,33,11,44
J44,2022,대구,질병,85,10,95
J44,2022,대전,질병,22,10,32
J44,2022,부산,질병,18,13,31
J44,2022,서울,질병,443,201,644
J44,2022,인천,질병,0,10,10
J44,2023,광주,질병,16,6,22
J44,2023,대구,질병,100,20,120
J44,2023,대전,질병,24,14,38
J44,2023,부산,질병,32,17,49
J44,2023,서울,질병,476,239,715
J44,2023,인천,질병,0,4,4
J45,2019,광주,질병,10,17,27
J45,2019,대구,질병,4,8,12
J45,2019,대전,질병,11,8,19
J45,2019,부산,질병,6,0,6
J45,2019,서울,질병,93,71,164
J45,2019,인천,질병,0,1,1
J45,2020,광주,질병,7,5,12
J45,2020,대구,질병,7,5,12
J45,2020,대전,질병,10,2,12
J45,2020,서울,질병,135,99,234
J45,2020,인천,질병,2,19,21
J45,2021,광주,질병,3,6,9
J45,2021,대구,질병,2,10,12
J45,2021,대전,질병,7,4,11
J45,2021,부산,질병,7,3,10
J45,2021,서울,질병,186,114,300
J45,2021,인천,질병,3,20,23
J45,2022,광주,질병,2,1,3
J45,2022,대구,질병,5,3,8
J45,2022,대전,질병,6,2,8
J45,2022,부산,질병,7,4,11
J45,2022,서울,질병,162,92,254
J45,2022,인천,질병,0,5,5
J45,2023,광주,질병,1,2,3
J45,2023,대구,질병,4,3,7
J45,2023,대전,질병,5,3,8
J45,2023,부산,질병,8,9,17
J45,2023,서울,질병,201,123,324
J45,2023,인천,질병,1,0,1
J46,2019,서울,질병,0,1,1
J47,2019,광주,질병,3,5,8
J47,2019,대구,질병,8,4,12
J47,2019,대전,질병,5,1,6
J47,2019,부산,질병,0,2,2
J47,2019,서울,질병,16,22,38
J47,2019,인천,질병,1,0,1
J47,2020,광주,질병,1,1,2
J47,2020,대구,질병,2,6,8
J47,2020,대전,질병,2,0,2
J47,2020,서울,질병,14,16,30
J47,2020,인천,질병,1,1,2
J47,2021,광주,질병,0,3,3
J47,2021,대구,질병,1,1,2
J47,2021,대전,질병,1,1,2
J47,2021,부산,질병,2,4,6
J47,2021,서울,질병,9,13,22
J47,2021,인천,질병,0,1,1
J47,2022,광주,질병,0,1,1
J47,2022,대구,질병,3,0,3
J47,2022,부산,질병,0,4,4
J47,2022,서울,질병,9,10,19
J47,2023,대구,질병,0,1,1
J47,2023,대전,질병,1,0,1
J47,2023,부산,질병,1,1,2
J47,2023,서울,질병,11,18,29
J47,2023,인천,질병,0,1,1
J60,2019,서울,질병,3,4,7
J60,2020,대전,질병,2,0,2
J60,2020,서울,질병,1,3,4
J60,2021,서울,질병,6,2,8
J60,2022,서울,질병,2,1,3
J60,2023,서울,질병,2,4,6
J61,2021,서울,질병,0,2,2
J61,2022,서울,질병,0,1,1
J61,2023,서울,질병,0,1,1
J62,2019,서울,질병,0,1,1
J64,2019,광주,질병,1,1,2
J64,2019,대전,질병,1,0,1
J64,2019,부산,질병,1,0,1
J64,2019,서울,질병,4,5,9
J64,2020,광주,질병,0,1,1
J64,2020,대전,질병,0,1,1
J64,2020,서울,질병,3,2,5
J64,2021,서울,질병,3,2,5
J64,2022,서울,질병,2,1,3
J64,2023,대전,질병,1,0,1
J64,2023,서울,질병,2,3,5
J65,2019,서울,질병,0,1,1
J67,2019,대구,질병,0,1,1
J67,2019,부산,질병,0,1,1
J67,2021,광주,질병,0,1,1
J67,2021,대구,질병,2,0,2
J67,2022,대구,질병,1,1,2
J68,2021,서울,질병,0,1,1
J69,2019,광주,질병,58,63,121
J69,2019,대구,질병,20,16,36
J69,2019,대전,질병,16,16,32
J69,2019,부산,질병,3,0,3
J69,2019,서울,질병,183,160,343
J69,2020,광주,질병,41,41,82
J69,2020,대구,질병,15,15,30
J69,2020,대전,질병,15,10,25
J69,2020,서울,질병,221,159,380
J69,2021,광주,질병,32,37,69
J69,2021,대구,질병,16,13,29
J69,2021,대전,질병,8,6,14
J69,2021,부산,질병,2,0,2
J69,2021,서울,질병,123,80,203
J69,2021,인천,질병,0,2,2
J69,2022,광주,질병,20,11,31
J69,2022,대구,질병,32,14,46
J69,2022,대전,질병,9,5,14
J69,2022,부산,질병,2,1,3
J69,2022,서울,질병,172,124,296
J69,2023,광주,질병,12,9,21
J69,2023,대구,질병,23,15,38
J69,2023,대전,질병,14,4,18
J69,2023,부산,질병,0,1,1
J69,2023,서울,질병,200,149,349
J70,2019,광주,질병,1,0,1
J70,2019,대전,질병,0,1,1
J70,2019,서울,질병,1,1,2
J70,2020,대전,질병,1,0,1
J70,2020,서울,질병,3,1,4
J70,2021,광주,질병,1,0,1
J70,2021,대구,질병,0,1,1
J70,2021,서울,질병,11,3,14
J70,2022,대전,질병,0,2,2
J70,2022,서울,질병,19,0,19
J70,2023,서울,질병,18,3,21
J80,2019,광주,질병,0,1,1
J80,2019,서울,질병,17,12,29
J80,2019,인천,질병,1,0,1
J80,2020,광주,질병,2,0,2
J80,2020,대전,질병,1,0,1
J80,2020,서울,질병,15,10,25
J80,2021,대전,질병,1,0,1
J80,2021,서울,질병,7,4,11
J80,2022,서울,질병,15,8,23
J80,2023,광주,질병,0,2,2
J80,2023,대전,질병,1,0,1
J80,2023,서울,질병,9,10,19
J81,2019,광주,질병,1,0,1
J81,2019,대전,질병,0,2,2
J81,2019,서울,질병,27,27,54
J81,2020,대전,질병,0,1,1
J81,2020,서울,질병,36,31,67
J81,2020,인천,질병,0,1,1
J81,2021,광주,질병,2,2,4
J81,2021,서울,질병,21,17,38
J81,2022,서울,질병,15,20,35
J81,2022,인천,질병,0,2,2
J81,2023,광주,질병,0,1,1
J81,2023,서울,질병,24,11,35
J82,2019,서울,질병,0,1,1
J82,2020,서울,질병,2,1,3
J82,2021,서울,질병,2,0,2
J82,2022,서울,질병,1,0,1
J82,2023,대전,질병,0,1,1
J82,2023,서울,질병,0,1,1
J84,2019,광주,질병,17,9,26
J84,2019,대구,질병,11,1,12
J84,2019,대전,질병,5,1,6
J84,2019,부산,질병,0,2,2
J84,2019,서울,질병,52,50,102
J84,2019,인천,질병,0,4,4
J84,2020,광주,질병,8,5,13
J84,2020,대구,질병,8,0,8
J84,2020,대전,질병,5,4,9
J84,2020,서울,질병,71,42,113
J84,2020,인천,질병,2,1,3
J84,2021,광주,질병,11,9,20
J84,2021,대구,질병,5,2,7
J84,2021,대전,질병,2,1,3
J84,2021,부산,질병,4,2,6
J84,2021,서울,질병,44,35,79
J84,2021,인천,질병,0,1,1
J84,2022,광주,질병,8,2,10
J84,2022,대구,질병,8,3,11
J84,2022,대전,질병,4,3,7
J84,2022,부산,질병,5,0,5
J84,2022,서울,질병,63,44,107
J84,2023,광주,질병,5,4,9
J84,2023,대구,질병,8,1,9
J84,2023,대전,질병,1,1,2
J84,2023,부산,질병,12,1,13
J84,2023,서울,질병,83,46,129
J85,2019,대구,질병,1,0,1
J85,2019,서울,질병,7,2,9
J85,2020,광주,질병,0,2,2
J85,2020,서울,질병,11,11,22
J85,2021,대구,질병,1,0,1
J85,2021,부산,질병,1,2,3
J85,2021,서울,질병,7,3,10
J85,2022,광주,질병,2,0,2
J85,2022,대구,질병,1,0,1
J85,2022,부산,질병,1,0,1
J85,2022,서울,질병,4,3,7
J85,2023,광주,질병,1,0,1
J85,2023,부산,질병,2,0,2
J85,2023,서울,질병,9,7,16
J86,2019,광주,질병,5,1,6
J86,2019,대구,질병,0,1,1
J86,2019,대전,질병,1,0,1
J86,2019,서울,질병,13,8,21
J86,2020,광주,질병,2,3,5
J86,2020,서울,질병,19,12,31
J86,2020,인천,질병,1,0,1
J86,2021,광주,질병,1,3,4
J86,2021,서울,질병,25,8,33
J86,2021,인천,질병,0,4,4
J86,2022,광주,질병,2,1,3
J86,2022,대구,질병,1,0,1
J86,2022,대전,질병,1,0,1
J86,2022,서울,질병,5,5,10
J86,2023,광주,질병,2,0,2
J86,2023,대전,질병,2,0,2
J86,2023,서울,질병,25,13,38
J90,2019,광주,질병,2,11,13
J90,2019,대구,질병,14,21,35
J90,2019,대전,질병,18,24,42
J90,2019,부산,질병,1,1,2
J90,2019,서울,질병,324,279,603
J90,2019,인천,질병,0,1,1
J90,2020,광주,질병,1,7,8
J90,2020,대구,질병,11,5,16
J90,2020,대전,질병,9,9,18
J90,2020,서울,질병,330,282,612
J90,2020,인천,질병,0,3,3
J90,2021,광주,질병,5,7,12
J90,2021,대구,질병,20,10,30
J90,2021,대전,질병,10,8,18
J90,2021,부산,질병,9,3,12
J90,2021,서울,질병,168,164,332
J90,2021,인천,질병,0,7,7
J90,2022,광주,질병,1,2,3
J90,2022,대구,질병,21,26,47
J90,2022,대전,질병,4,12,16
J90,2022,부산,질병,5,5,10
J90,2022,서울,질병,192,174,366
J90,2023,광주,질병,2,1,3
J90,2023,대구,질병,31,27,58
J90,2023,대전,질병,24,20,44
J90,2023,부산,질병,4,3,7
J90,2023,서울,질병,164,169,333
J90,2023,인천,질병,0,1,1
J91,2019,부산,질병,1,0,1
J91,2020,대구,질병,1,0,1
J91,2020,서울,질병,1,0,1
J91,2021,부산,질병,1,1,2
J91,2022,부산,질병,1,0,1
J91,2023,광주,질병,0,2,2
J91,2023,대전,질병,0,1,1
J93,2019,광주,질병,3,1,4
J93,2019,대구,질병,3,3,6
J93,2019,대전,질병,7,3,10
J93,2019,부산,질병,5,0,5
J93,2019,서울,질병,31,41,72
J93,2020,광주,질병,2,0,2
J93,2020,대구,질병,3,5,8
J93,2020,대전,질병,9,3,12
J93,2020,서울,질병,31,33,64
J93,2021,광주,질병,4,2,6
J93,2021,대구,질병,3,2,5
J93,2021,대전,질병,7,3,10
J93,2021,부산,질병,1,0,1
J93,2021,서울,질병,28,35,63
J93,2022,광주,질병,8,1,9
J93,2022,대구,질병,8,1,9
J93,2022,대전,질병,3,3,6
J93,2022,부산,질병,0,3,3
J93,2022,서울,질병,28,38,66
J93,2023,광주,질병,4,2,6
J93,2023,대구,질병,6,1,7
J93,2023,대전,질병,4,1,5
J93,2023,부산,질병,1,2,3
J93,2023,서울,질병,35,37,72
J94,2019,광주,질병,1,1,2
J94,2019,대구,질병,0,3,3
J94,2019,대전,질병,1,0,1
J94,2019,서울,질병,10,13,23
J94,2020,서울,질병,14,6,20
J94,2021,광주,질병,1,1,2
J94,2021,부산,질병,2,0,2
J94,2021,서울,질병,15,8,23
J94,2022,광주,질병,0,2,2
J94,2022,부산,질병,0,1,1
J94,2022,서울,질병,17,6,23
J94,2023,광주,질병,0,1,1
J94,2023,대구,질병,0,1,1
J94,2023,서울,질병,16,10,26
J95,2019,서울,질병,25,15,40
J95,2020,서울,질병,15,10,25
J95,2021,서울,질병,12,9,21
J95,2022,서울,질병,21,12,33
J95,2023,서울,질병,31,12,43
J96,2019,광주,질병,1,2,3
J96,2019,대구,질병,0,1,1
J96,2019,부산,질병,3,3,6
J96,2019,서울,질병,84,45,129
J96,2020,광주,질병,0,2,2
J96,2020,대구,질병,2,3,5
J96,2020,대전,질병,0,1,1
J96,2020,서울,질병,108,75,183
J96,2021,광주,질병,1,1,2
J96,2021,대구,질병,0,1,1
J96,2021,대전,질병,2,0,2
J96,2021,부산,질병,1,0,1
J96,2021,서울,질병,64,62,126
J96,2022,광주,질병,1,0,1
J96,2022,대구,질병,4,0,4
J96,2022,서울,질병,92,63,155
J96,2023,광주,질병,1,1,2
J96,2023,대구,질병,1,0,1
J96,2023,대전,질병,0,2,2
J96,2023,부산,질병,3,0,3
J96,2023,서울,질병,154,103,257
J98,2019,광주,질병,3,1,4
J98,2019,대구,질병,9,4,13
J98,2019,대전,질병,5,3,8
J98,2019,부산,질병,2,2,4
J98,2019,서울,질병,113,76,189
J98,2020,광주,질병,3,1,4
J98,2020,대구,질병,4,2,6
J98,2020,대전,질병,7,7,14
J98,2020,서울,질병,118,87,205
J98,2021,광주,질병,3,3,6
J98,2021,대구,질병,3,2,5
J98,2021,대전,질병,5,6,11
J98,2021,부산,질병,2,0,2
J98,2021,서울,질병,95,76,171
J98,2022,대구,질병,4,2,6
J98,2022,대전,질병,3,6,9
J98,2022,부산,질병,2,1,3
J98,2022,서울,질병,100,63,163
J98,2023,광주,질병,1,1,2
J98,2023,대구,질병,2,1,3
J98,2023,대전,질병,9,4,13
J98,2023,서울,질병,131,96,227
J99,2019,서울,질병,4,4,8
J99,2020,서울,질병,2,5,7
J99,2021,서울,질병,3,2,5
J99,2022,서울,질병,1,5,6
J99,2023,서울,질병,6,4,10
K00,2021,서울,질병,1,0,1
K01,2019,서울,질병,0,1,1
K01,2020,서울,질병,1,1,2
K01,2021,서울,질병,0,1,1
K01,2022,서울,질병,4,1,5
K02,2019,대구,질병,4,0,4
K02,2019,서울,질병,24,16,40
K02,2019,인천,질병,2,0,2
K02,2020,대구,질병,1,0,1
K02,2020,서울,질병,39,19,58
K02,2020,인천,질병,2,0,2
K02,2021,대구,질병,2,0,2
K02,2021,서울,질병,23,17,40
K02,2021,인천,질병,2,0,2
K02,2022,부산,질병,1,0,1
K02,2022,서울,질병,33,20,53
K02,2023,서울,질병,28,23,51
K03,2019,서울,질병,4,1,5
K03,2019,인천,질병,4,0,4
K03,2020,서울,질병,2,0,2
K03,2021,서울,질병,7,2,9
K03,2022,서울,질병,6,4,10
K03,2023,대전,질병,0,1,1
K03,2023,서울,질병,5,4,9
K04,2019,서울,질병,4,3,7
K04,2020,대구,질병,0,1,1
K04,2020,서울,질병,7,4,11
K04,2020,인천,질병,1,0,1
K04,2021,광주,질병,0,1,1
K04,2021,서울,질병,6,2,8
K04,2021,인천,질병,3,0,3
K04,2022,광주,질병,1,0,1
K04,2022,대전,질병,1,0,1
K04,2022,서울,질병,12,1,13
K04,2023,서울,질병,4,2,6
K05,2019,광주,질병,1,2,3
K05,2019,대구,질병,1,0,1
K05,2019,부산,질병,3,0,3
K05,2019,서울,질병,37,14,51
K05,2019,인천,질병,11,0,11
K05,2020,대구,질병,2,0,2
K05,2020,대전,질병,1,0,1
K05,2020,서울,질병,39,18,57
K05,2020,인천,질병,9,0,9
K05,2021,광주,질병,0,1,1
K05,2021,대구,질병,3,0,3
K05,2021,부산,질병,2,0,2
K05,2021,서울,질병,22,14,36
K05,2021,인천,질병,0,2,2
K05,2022,대구,질병,3,0,3
K05,2022,대전,질병,0,1,1
K05,2022,부산,질병,2,0,2
K05,2022,서울,질병,47,20,67
K05,2022,인천,질병,0,1,1
K05,2023,대구,질병,3,0,3
K05,2023,대전,질병,5,1,6
K05,2023,부산,질병,2,0,2
K05,2023,서울,질병,51,31,82
K06,2019,서울,질병,2,0,2
K06,2020,서울,질병,5,0,5
K06,2021,서울,질병,4,1,5
K06,2022,서울,질병,8,4,12
K06,2023,서울,질병,4,1,5
K07,2019,서울,질병,3,2,5
K07,2020,서울,질병,5,1,6
K07,2021,서울,질병,2,1,3
K07,2022,서울,질병,1,0,1
K07,2023,대전,질병,4,0,4
K07,2023,서울,질병,4,2,6
K08,2019,대전,질병,4,0,4
K08,2019,부산,질병,2,0,2
K08,2019,서울,질병,71,31,102
K08,2019,인천,질병,45,0,45
K08,2020,대전,질병,2,0,2
K08,2020,서울,질병,87,27,114
K08,2020,인천,질병,76,1,77
K08,2021,대전,질병,0,1,1
K08,2021,부산,질병,3,0,3
K08,2021,서울,질병,68,20,88
K08,2021,인천,질병,78,1,79
K08,2022,대구,질병,1,0,1
K08,2022,대전,질병,4,0,4
K08,2022,부산,질병,3,0,3
K08,2022,서울,질병,78,40,118
K08,2023,대전,질병,1,0,1
K08,2023,부산,질병,1,0,1
K08,2023,서울,질병,79,31,110
K09,2019,서울,질병,2,0,2
K09,2020,대전,질병,1,0,1
K09,2020,서울,질병,5,0,5
K09,2021,서울,질병,3,0,3
K09,2022,서울,질병,4,0,4
K09,2023,대전,질병,3,1,4
K09,2023,서울,질병,1,1,2
K10,2019,서울,질병,4,3,7
K10,2020,서울,질병,5,1,6
K10,2021,서울,질병,2,0,2
K10,2022,서울,질병,3,3,6
K10,2023,서울,질병,0,3,3
K11,2019,광주,질병,1,2,3
K11,2019,대구,질병,1,0,1
K11,2019,대전,질병,1,2,3
K11,2019,서울,질병,17,9,26
K11,2020,광주,질병,1,1,2
K11,2020,대구,질병,3,0,3
K11,2020,대전,질병,2,2,4
K11,2020,서울,질병,17,8,25
K11,2020,인천,질병,3,2,5
K11,2021,광주,질병,1,0,1
K11,2021,대전,질병,0,2,2
K11,2021,서울,질병,10,12,22
K11,2022,대구,질병,1,0,1
K11,2022,서울,질병,19,17,36
K11,2022,인천,질병,1,0,1
K11,2023,광주,질병,1,0,1
K11,2023,대전,질병,0,1,1
K11,2023,서울,질병,10,9,19
K11,2023,인천,질병,0,1,1
K12,2019,대구,질병,1,1,2
K12,2019,서울,질병,10,7,17
K12,2019,인천,질병,0,1,1
K12,2020,광주,질병,0,1,1
K12,2020,대구,질병,1,0,1
K12,2020,대전,질병,1,0,1
K12,2020,서울,질병,17,5,22
K12,2020,인천,질병,1,1,2
K12,2021,광주,질병,0,1,1
K12,2021,대전,질병,1,0,1
K12,2021,서울,질병,18,9,27
K12,2021,인천,질병,1,0,1
K12,2022,광주,질병,0,1,1
K12,2022,서울,질병,12,6,18
K12,2023,서울,질병,16,13,29
K12,2023,인천,질병,1,0,1
K13,2019,서울,질병,4,2,6
K13,2020,대전,질병,0,1,1
K13,2020,서울,질병,8,1,9
K13,2021,서울,질병,8,1,9
K13,2022,서울,질병,7,4,11
K13,2023,대전,질병,1,1,2
K13,2023,서울,질병,7,5,12
K14,2019,대구,질병,0,1,1
K14,2019,대전,질병,2,0,2
K14,2019,서울,질병,5,4,9
K14,2020,대구,질병,1,0,1
K14,2020,서울,질병,15,7,22
K14,2021,서울,질병,4,4,8
K14,2022,서울,질병,9,8,17
K14,2023,대전,질병,2,0,2
K14,2023,서울,질병,3,8,11
K20,2019,대전,질병,1,0,1
K20,2019,서울,질병,13,3,16
K20,2020,광주,질병,0,2,2
K20,2020,대구,질병,1,0,1
K20,2020,대전,질병,0,1,1
K20,2020,서울,질병,4,3,7
K20,2021,대전,질병,0,1,1
K20,2021,서울,질병,3,0,3
K20,2022,서울,질병,9,8,17
K20,2023,광주,질병,0,1,1
K20,2023,대구,질병,0,1,1
K20,2023,서울,질병,7,7,14
K21,2019,광주,질병,12,14,26
K21,2019,대구,질병,77,29,106
K21,2019,대전,질병,81,29,110
K21,2019,부산,질병,49,14,63
K21,2019,서울,질병,54,27,81
K21,2019,인천,질병,1,1,2
K21,2020,광주,질병,11,22,33
K21,2020,대구,질병,70,28,98
K21,2020,대전,질병,114,21,135
K21,2020,서울,질병,42,28,70
K21,2020,인천,질병,3,2,5
K21,2021,광주,질병,17,8,25
K21,2021,대구,질병,70,20,90
K21,2021,대전,질병,84,18,102
K21,2021,부산,질병,52,10,62
K21,2021,서울,질병,53,53,106
K21,2021,인천,질병,2,2,4
K21,2022,광주,질병,9,7,16
K21,2022,대구,질병,97,39,136
K21,2022,대전,질병,64,19,83
K21,2022,부산,질병,46,19,65
K21,2022,서울,질병,144,111,255
K21,2023,광주,질병,17,13,30
K21,2023,대구,질병,60,26,86
K21,2023,대전,질병,71,19,90
K21,2023,부산,질병,50,13,63
K21,2023,서울,질병,121,89,210
K22,2019,광주,질병,1,1,2
K22,2019,대구,질병,3,1,4
K22,2019,대전,질병,2,3,5
K22,2019,부산,질병,2,1,3
K22,2019,서울,질병,31,16,47
K22,2020,광주,질병,2,2,4
K22,2020,대구,질병,1,1,2
K22,2020,대전,질병,2,5,7
K22,2020,서울,질병,29,19,48
K22,2021,광주,질병,2,1,3
K22,2021,대구,질병,5,2,7
K22,2021,대전,질병,6,4,10
K22,2021,부산,질병,3,2,5
K22,2021,서울,질병,23,9,32
K22,2021,인천,질병,1,0,1
K22,2022,광주,질병,2,0,2
K22,2022,대구,질병,5,0,5
K22,2022,대전,질병,5,5,10
K22,2022,서울,질병,30,12,42
K22,2023,광주,질병,2,3,5
K22,2023,대구,질병,4,3,7
K22,2023,대전,질병,5,5,10
K22,2023,부산,질병,2,2,4
K22,2023,서울,질병,40,10,50
K22,2023,인천,질병,1,1,2
K25,2019,광주,질병,16,16,32
K25,2019,대구,질병,33,18,51
K25,2019,대전,질병,31,19,50
K25,2019,부산,질병,13,2,15
K25,2019,서울,질병,77,73,150
K25,2019,인천,질병,1,4,5
K25,2020,광주,질병,18,14,32
K25,2020,대구,질병,23,13,36
K25,2020,대전,질병,59,25,84
K25,2020,서울,질병,77,70,147
K25,2020,인천,질병,1,1,2
K25,2021,광주,질병,5,6,11
K25,2021,대구,질병,48,32,80
K25,2021,대전,질병,57,20,77
K25,2021,부산,질병,14,3,17
K25,2021,서울,질병,43,41,84
K25,2022,광주,질병,6,8,14
K25,2022,대구,질병,50,22,72
K25,2022,대전,질병,38,13,51
K25,2022,부산,질병,8,4,12
K25,2022,서울,질병,68,56,124
K25,2023,광주,질병,10,6,16
K25,2023,대구,질병,21,19,40
K25,2023,대전,질병,20,4,24
K25,2023,부산,질병,7,4,11
K25,2023,서울,질병,105,61,166
K25,2023,인천,질병,2,0,2
K26,2019,광주,질병,4,5,9
K26,2019,대구,질병,3,3,6
K26,2019,대전,질병,13,2,15
K26,2019,부산,질병,6,2,8
K26,2019,서울,질병,25,22,47
K26,2019,인천,질병,0,3,3
K26,2020,광주,질병,4,6,10
K26,2020,대구,질병,5,1,6
K26,2020,대전,질병,9,7,16
K26,2020,서울,질병,24,23,47
K26,2021,광주,질병,2,4,6
K26,2021,대구,질병,3,0,3
K26,2021,대전,질병,11,6,17
K26,2021,부산,질병,4,2,6
K26,2021,서울,질병,8,14,22
K26,2021,인천,질병,0,1,1
K26,2022,광주,질병,3,3,6
K26,2022,대구,질병,2,0,2
K26,2022,대전,질병,7,2,9
K26,2022,부산,질병,8,1,9
K26,2022,서울,질병,19,22,41
K26,2023,광주,질병,2,4,6
K26,2023,대구,질병,3,0,3
K26,2023,대전,질병,7,1,8
K26,2023,부산,질병,6,5,11
K26,2023,서울,질병,28,19,47
K26,2023,인천,질병,1,0,1
K27,2019,광주,질병,3,1,4
K27,2019,대구,질병,3,0,3
K27,2019,대전,질병,2,0,2
K27,2019,부산,질병,9,1,10
K27,2019,서울,질병,7,3,10
K27,2019,인천,질병,0,1,1
K27,2020,대구,질병,1,1,2
K27,2020,대전,질병,2,3,5
K27,2020,서울,질병,4,0,4
K27,2020,인천,질병,0,1,1
K27,2021,광주,질병,2,3,5
K27,2021,대구,질병,0,2,2
K27,2021,대전,질병,1,0,1
K27,2021,부산,질병,2,0,2
K27,2021,서울,질병,2,1,3
K27,2022,광주,질병,1,0,1
K27,2022,대구,질병,2,0,2
K27,2022,대전,질병,0,2,2
K27,2022,부산,질병,3,1,4
K27,2022,서울,질병,4,4,8
K27,2023,부산,질병,1,0,1
K27,2023,서울,질병,6,1,7
K28,2019,대구,질병,0,1,1
K28,2019,서울,질병,4,0,4
K28,2020,대전,질병,1,0,1
K28,2020,서울,질병,6,0,6
K28,2020,인천,질병,1,0,1
K28,2021,서울,질병,1,0,1
K28,2023,서울,질병,0,1,1
K29,2019,광주,질병,6,7,13
K29,2019,대구,질병,67,43,110
K29,2019,대전,질병,289,95,384
K29,2019,부산,질병,185,33,218
K29,2019,서울,질병,359,268,627
K29,2019,인천,질병,5,6,11
K29,2020,광주,질병,4,9,13
K29,2020,대구,질병,47,14,61
K29,2020,대전,질병,395,125,520
K29,2020,서울,질병,331,259,590
K29,2020,인천,질병,2,12,14
K29,2021,광주,질병,10,7,17
K29,2021,대구,질병,43,14,57
K29,2021,대전,질병,435,140,575
K29,2021,부산,질병,179,34,213
K29,2021,서울,질병,193,165,358
K29,2021,인천,질병,9,12,21
K29,2022,광주,질병,7,2,9
K29,2022,대구,질병,49,12,61
K29,2022,대전,질병,318,83,401
K29,2022,부산,질병,123,27,150
K29,2022,서울,질병,297,216,513
K29,2022,인천,질병,1,7,8
K29,2023,광주,질병,14,14,28
K29,2023,대구,질병,35,12,47
K29,2023,대전,질병,281,122,403
K29,2023,부산,질병,84,13,97
K29,2023,서울,질병,383,282,665
K29,2023,인천,질병,5,6,11
K30,2019,광주,질병,1,0,1
K30,2019,대구,질병,3,4,7
K30,2019,대전,질병,3,0,3
K30,2019,부산,질병,42,10,52
K30,2019,서울,질병,14,9,23
K30,2019,인천,질병,4,5,9
K30,2020,광주,질병,1,1,2
K30,2020,대구,질병,14,2,16
K30,2020,대전,질병,6,7,13
K30,2020,서울,질병,3,7,10
K30,2020,인천,질병,2,5,7
K30,2021,광주,질병,2,0,2
K30,2021,대구,질병,18,8,26
K30,2021,대전,질병,17,8,25
K30,2021,부산,질병,25,6,31
K30,2021,서울,질병,6,8,14
K30,2021,인천,질병,2,2,4
K30,2022,광주,질병,6,4,10
K30,2022,대구,질병,49,19,68
K30,2022,대전,질병,5,0,5
K30,2022,부산,질병,16,5,21
K30,2022,서울,질병,4,10,14
K30,2022,인천,질병,0,1,1
K30,2023,광주,질병,4,17,21
K30,2023,대구,질병,27,15,42
K30,2023,대전,질병,2,2,4
K30,2023,부산,질병,8,1,9
K30,2023,서울,질병,10,9,19
K30,2023,인천,질병,1,6,7
K31,2019,광주,질병,14,16,30
K31,2019,대구,질병,6,3,9
K31,2019,대전,질병,19,9,28
K31,2019,부산,질병,10,5,15
K31,2019,서울,질병,37,23,60
K31,2019,인천,질병,3,5,8
K31,2020,광주,질병,3,3,6
K31,2020,대구,질병,3,1,4
K31,2020,대전,질병,32,12,44
K31,2020,서울,질병,31,16,47
K31,2020,인천,질병,0,3,3
K31,2021,광주,질병,4,7,11
K31,2021,대구,질병,5,2,7
K31,2021,대전,질병,43,18,61
K31,2021,부산,질병,19,7,26
K31,2021,서울,질병,19,18,37
K31,2021,인천,질병,1,1,2
K31,2022,광주,질병,2,2,4
K31,2022,대구,질병,11,2,13
K31,2022,대전,질병,27,9,36
K31,2022,부산,질병,8,4,12
K31,2022,서울,질병,24,22,46
K31,2023,광주,질병,2,2,4
K31,2023,대구,질병,8,5,13
K31,2023,대전,질병,18,6,24
K31,2023,부산,질병,6,5,11
K31,2023,서울,질병,34,21,55
K35,2019,광주,질병,11,65,76
K35,2019,대구,질병,7,6,13
K35,2019,대전,질병,7,21,28
K35,2019,부산,질병,9,1,10
K35,2019,서울,질병,27,47,74
K35,2019,인천,질병,0,2,2
K35,2020,광주,질병,9,48,57
K35,2020,대구,질병,7,7,14
K35,2020,대전,질병,7,23,30
K35,2020,서울,질병,20,48,68
K35,2020,인천,질병,0,3,3
K35,2021,광주,질병,8,42,50
K35,2021,대구,질병,7,18,25
K35,2021,대전,질병,6,11,17
K35,2021,부산,질병,9,11,20
K35,2021,서울,질병,16,28,44
K35,2022,광주,질병,6,42,48
K35,2022,대구,질병,7,10,17
K35,2022,대전,질병,4,18,22
K35,2022,부산,질병,6,3,9
K35,2022,서울,질병,21,41,62
K35,2023,광주,질병,17,40,57
K35,2023,대구,질병,5,12,17
K35,2023,대전,질병,4,9,13
K35,2023,부산,질병,8,2,10
K35,2023,서울,질병,28,39,67
K35,2023,인천,질병,0,4,4
K36,2019,광주,질병,1,0,1
K36,2019,서울,질병,1,2,3
K36,2019,인천,질병,0,1,1
K36,2020,광주,질병,3,8,11
K36,2020,대구,질병,1,0,1
K36,2021,광주,질병,2,1,3
K36,2021,서울,질병,3,1,4
K36,2022,광주,질병,4,1,5
K36,2022,부산,질병,1,0,1
K36,2022,서울,질병,3,2,5
K36,2023,광주,질병,2,7,9
K36,2023,서울,질병,2,3,5
K38,2019,서울,질병,5,13,18
K38,2020,광주,질병,2,0,2
K38,2020,대구,질병,1,1,2
K38,2020,대전,질병,1,1,2
K38,2020,서울,질병,2,16,18
K38,2021,대전,질병,1,0,1
K38,2021,서울,질병,3,10,13
K38,2022,광주,질병,1,2,3
K38,2022,대구,질병,1,0,1
K38,2022,대전,질병,2,0,2
K38,2022,서울,질병,5,10,15
K38,2023,광주,질병,0,2,2
K38,2023,서울,질병,9,14,23
K40,2019,광주,질병,30,40,70
K40,2019,대구,질병,29,18,47
K40,2019,대전,질병,26,22,48
K40,2019,부산,질병,33,23,56
K40,2019,서울,질병,121,162,283
K40,2019,인천,질병,6,10,16
K40,2020,광주,질병,32,40,72
K40,2020,대구,질병,24,19,43
K40,2020,대전,질병,26,21,47
K40,2020,서울,질병,100,118,218
K40,2020,인천,질병,4,14,18
K40,2021,광주,질병,35,39,74
K40,2021,대구,질병,22,21,43
K40,2021,대전,질병,30,32,62
K40,2021,부산,질병,25,19,44
K40,2021,서울,질병,82,100,182
K40,2021,인천,질병,3,8,11
K40,2022,광주,질병,33,32,65
K40,2022,대구,질병,40,20,60
K40,2022,대전,질병,24,23,47
K40,2022,부산,질병,30,27,57
K40,2022,서울,질병,126,89,215
K40,2022,인천,질병,1,2,3
K40,2023,광주,질병,26,23,49
K40,2023,대구,질병,32,15,47
K40,2023,대전,질병,25,40,65
K40,2023,부산,질병,49,30,79
K40,2023,서울,질병,124,113,237
K40,2023,인천,질병,2,12,14
K41,2019,서울,질병,1,1,2
K41,2020,광주,질병,1,0,1
K41,2020,서울,질병,0,2,2
K41,2021,서울,질병,2,4,6
K41,2022,광주,질병,0,1,1
K41,2022,서울,질병,1,1,2
K41,2023,광주,질병,0,2,2
K41,2023,서울,질병,1,4,5
K42,2019,대구,질병,1,0,1
K42,2019,부산,질병,1,0,1
K42,2019,서울,질병,3,2,5
K42,2020,광주,질병,1,3,4
K42,2020,서울,질병,5,6,11
K42,2020,인천,질병,0,1,1
K42,2021,광주,질병,1,0,1
K42,2021,대구,질병,0,1,1
K42,2021,부산,질병,3,0,3
K42,2021,서울,질병,1,4,5
K42,2022,대전,질병,1,1,2
K42,2022,부산,질병,1,0,1
K42,2022,서울,질병,3,3,6
K42,2023,광주,질병,2,1,3
K42,2023,부산,질병,2,1,3
K42,2023,서울,질병,1,8,9
K43,2019,광주,질병,2,2,4
K43,2019,대구,질병,2,0,2
K43,2019,대전,질병,0,2,2
K43,2019,서울,질병,14,13,27
K43,2020,광주,질병,3,4,7
K43,2020,대구,질병,4,0,4
K43,2020,대전,질병,2,0,2
K43,2020,서울,질병,19,8,27
K43,2021,광주,질병,1,0,1
K43,2021,대구,질병,0,1,1
K43,2021,대전,질병,0,1,1
K43,2021,부산,질병,0,1,1
K43,2021,서울,질병,16,8,24
K43,2021,인천,질병,0,2,2
K43,2022,광주,질병,7,5,12
K43,2022,대구,질병,1,0,1
K43,2022,대전,질병,2,1,3
K43,2022,부산,질병,1,0,1
K43,2022,서울,질병,13,10,23
K43,2023,광주,질병,5,1,6
K43,2023,대구,질병,0,1,1
K43,2023,대전,질병,2,1,3
K43,2023,서울,질병,19,7,26
K44,2019,대구,질병,1,0,1
K44,2019,대전,질병,0,1,1
K44,2019,서울,질병,9,5,14
K44,2020,광주,질병,0,2,2
K44,2020,대구,질병,3,0,3
K44,2020,서울,질병,9,10,19
K44,2021,대전,질병,1,0,1
K44,2021,서울,질병,1,3,4
K44,2022,광주,질병,1,0,1
K44,2022,서울,질병,7,5,12
K44,2023,광주,질병,0,1,1
K44,2023,서울,질병,10,20,30
K45,2019,대구,질병,0,1,1
K45,2019,서울,질병,3,1,4
K45,2020,서울,질병,1,1,2
K45,2021,광주,질병,0,1,1
K45,2021,서울,질병,1,0,1
K45,2022,서울,질병,2,2,4
K45,2023,서울,질병,0,1,1
K46,2019,대전,질병,0,1,1
K46,2019,부산,질병,1,0,1
K46,2020,광주,질병,1,0,1
K46,2020,서울,질병,3,1,4
K46,2020,인천,질병,0,1,1
K46,2021,광주,질병,1,1,2
K46,2021,서울,질병,3,0,3
K46,2022,부산,질병,1,0,1
K46,2022,서울,질병,1,1,2
K46,2023,광주,질병,2,1,3
K46,2023,대전,질병,1,0,1
K46,2023,서울,질병,1,2,3
K50,2019,광주,질병,3,0,3
K50,2019,부산,질병,1,0,1
K50,2019,서울,질병,1,1,2
K50,2019,인천,질병,0,1,1
K50,2020,광주,질병,3,2,5
K50,2020,대전,질병,0,1,1
K50,2020,서울,질병,3,1,4
K50,2020,인천,질병,2,0,2
K50,2021,광주,질병,2,1,3
K50,2021,대전,질병,0,1,1
K50,2021,부산,질병,1,0,1
K50,2022,대전,질병,0,1,1
K50,2022,부산,질병,2,0,2
K50,2022,서울,질병,1,1,2
K50,2023,부산,질병,1,0,1
K50,2023,서울,질병,3,0,3
K51,2019,광주,질병,2,5,7
K51,2019,대구,질병,0,2,2
K51,2019,대전,질병,5,2,7
K51,2019,부산,질병,1,1,2
K51,2019,서울,질병,9,10,19
K51,2020,광주,질병,0,5,5
K51,2020,대구,질병,0,1,1
K51,2020,대전,질병,1,2,3
K51,2020,서울,질병,14,6,20
K51,2021,광주,질병,2,2,4
K51,2021,대구,질병,2,0,2
K51,2021,대전,질병,3,2,5
K51,2021,부산,질병,0,1,1
K51,2021,서울,질병,4,5,9
K51,2022,광주,질병,4,2,6
K51,2022,대구,질병,2,1,3
K51,2022,대전,질병,2,2,4
K51,2022,부산,질병,2,0,2
K51,2022,서울,질병,11,3,14
K51,2023,광주,질병,3,2,5
K51,2023,대구,질병,1,0,1
K51,2023,대전,질병,0,2,2
K51,2023,부산,질병,0,1,1
K51,2023,서울,질병,11,15,26
K52,2019,광주,질병,3,20,23
K52,2019,대구,질병,1,0,1
K52,2019,대전,질병,11,5,16
K52,2019,부산,질병,18,3,21
K52,2019,서울,질병,21,22,43
K52,2020,광주,질병,1,13,14
K52,2020,대구,질병,2,0,2
K52,2020,대전,질병,8,3,11
K52,2020,서울,질병,37,24,61
K52,2021,대전,질병,9,2,11
K52,2021,부산,질병,7,4,11
K52,2021,서울,질병,27,18,45
K52,2021,인천,질병,0,1,1
K52,2022,광주,질병,2,3,5
K52,2022,대전,질병,9,7,16
K52,2022,부산,질병,8,4,12
K52,2022,서울,질병,41,27,68
K52,2023,광주,질병,4,3,7
K52,2023,대전,질병,4,0,4
K52,2023,부산,질병,6,2,8
K52,2023,서울,질병,50,36,86
K55,2019,광주,질병,8,4,12
K55,2019,대구,질병,0,2,2
K55,2019,대전,질병,4,2,6
K55,2019,부산,질병,7,1,8
K55,2019,서울,질병,26,20,46
K55,2020,광주,질병,4,9,13
K55,2020,대구,질병,3,1,4
K55,2020,대전,질병,5,2,7
K55,2020,서울,질병,19,38,57
K55,2020,인천,질병,0,1,1
K55,2021,광주,질병,11,7,18
K55,2021,대구,질병,1,1,2
K55,2021,대전,질병,2,1,3
K55,2021,부산,질병,7,0,7
K55,2021,서울,질병,15,19,34
K55,2021,인천,질병,0,1,1
K55,2022,광주,질병,8,6,14
K55,2022,대구,질병,4,1,5
K55,2022,대전,질병,8,1,9
K55,2022,부산,질병,5,1,6
K55,2022,서울,질병,33,16,49
K55,2022,인천,질병,1,0,1
K55,2023,광주,질병,1,6,7
K55,2023,대구,질병,1,3,4
K55,2023,대전,질병,7,2,9
K55,2023,부산,질병,2,0,2
K55,2023,서울,질병,30,23,53
K56,2019,광주,질병,21,16,37
K56,2019,대구,질병,10,6,16
K56,2019,대전,질병,22,10,32
K56,2019,부산,질병,26,1,27
K56,2019,서울,질병,62,54,116
K56,2019,인천,질병,0,1,1
K56,2020,광주,질병,13,15,28
K56,2020,대구,질병,15,6,21
K56,2020,대전,질병,16,12,28
K56,2020,서울,질병,87,59,146
K56,2020,인천,질병,10,4,14
K56,2021,광주,질병,21,17,38
K56,2021,대구,질병,13,3,16
K56,2021,대전,질병,25,11,36
K56,2021,부산,질병,19,5,24
K56,2021,서울,질병,74,56,130
K56,2021,인천,질병,6,17,23
K56,2022,광주,질병,15,5,20
K56,2022,대구,질병,13,5,18
K56,2022,대전,질병,22,7,29
K56,2022,부산,질병,25,2,27
K56,2022,서울,질병,81,54,135
K56,2023,광주,질병,15,11,26
K56,2023,대구,질병,14,5,19
K56,2023,대전,질병,10,8,18
K56,2023,부산,질병,17,5,22
K56,2023,서울,질병,89,47,136
K56,2023,인천,질병,1,4,5
K57,2019,광주,질병,4,6,10
K57,2019,대구,질병,2,5,7
K57,2019,대전,질병,5,5,10
K57,2019,부산,질병,2,3,5
K57,2019,서울,질병,24,28,52
K57,2020,광주,질병,1,8,9
K57,2020,대구,질병,4,6,10
K57,2020,대전,질병,5,5,10
K57,2020,서울,질병,17,20,37
K57,2020,인천,질병,1,2,3
K57,2021,광주,질병,0,18,18
K57,2021,대구,질병,4,3,7
K57,2021,대전,질병,3,1,4
K57,2021,부산,질병,1,2,3
K57,2021,서울,질병,13,8,21
K57,2021,인천,질병,2,1,3
K57,2022,광주,질병,5,6,11
K57,2022,대구,질병,9,2,11
K57,2022,대전,질병,4,14,18
K57,2022,부산,질병,3,3,6
K57,2022,서울,질병,26,32,58
K57,2022,인천,질병,1,1,2
K57,2023,광주,질병,4,9,13
K57,2023,대구,질병,7,5,12
K57,2023,대전,질병,5,6,11
K57,2023,부산,질병,2,2,4
K57,2023,서울,질병,47,59,106
K57,2023,인천,질병,0,4,4
K58,2019,광주,질병,2,3,5
K58,2019,대구,질병,26,4,30
K58,2019,대전,질병,20,12,32
K58,2019,부산,질병,71,10,81
K58,2019,서울,질병,4,3,7
K58,2019,인천,질병,5,12,17
K58,2020,광주,질병,7,1,8
K58,2020,대구,질병,19,2,21
K58,2020,대전,질병,43,15,58
K58,2020,서울,질병,1,1,2
K58,2020,인천,질병,6,6,12
K58,2021,광주,질병,2,3,5
K58,2021,대구,질병,9,1,10
K58,2021,대전,질병,29,8,37
K58,2021,부산,질병,23,10,33
K58,2021,서울,질병,0,2,2
K58,2021,인천,질병,1,0,1
K58,2022,광주,질병,2,2,4
K58,2022,대구,질병,8,1,9
K58,2022,대전,질병,12,7,19
K58,2022,부산,질병,6,2,8
K58,2022,서울,질병,1,0,1
K58,2022,인천,질병,1,1,2
K58,2023,광주,질병,3,1,4
K58,2023,대구,질병,6,1,7
K58,2023,대전,질병,7,4,11
K58,2023,부산,질병,4,4,8
K58,2023,서울,질병,1,0,1
K58,2023,인천,질병,3,0,3
K59,2019,광주,질병,3,2,5
K59,2019,대구,질병,46,31,77
K59,2019,대전,질병,110,37,147
K59,2019,부산,질병,47,12,59
K59,2019,서울,질병,43,43,86
K59,2019,인천,질병,2,5,7
K59,2020,광주,질병,7,3,10
K59,2020,대구,질병,25,14,39
K59,2020,대전,질병,110,42,152
K59,2020,서울,질병,76,58,134
K59,2020,인천,질병,13,9,22
K59,2021,광주,질병,1,4,5
K59,2021,대구,질병,79,32,111
K59,2021,대전,질병,94,45,139
K59,2021,부산,질병,47,17,64
K59,2021,서울,질병,54,58,112
K59,2021,인천,질병,10,0,10
K59,2022,광주,질병,3,5,8
K59,2022,대구,질병,115,73,188
K59,2022,대전,질병,73,29,102
K59,2022,부산,질병,39,10,49
K59,2022,서울,질병,61,48,109
K59,2023,광주,질병,27,16,43
K59,2023,대구,질병,70,35,105
K59,2023,대전,질병,65,7,72
K59,2023,부산,질병,20,7,27
K59,2023,서울,질병,43,40,83
K59,2023,인천,질병,1,1,2
K60,2019,광주,질병,9,6,15
K60,2019,대구,질병,4,1,5
K60,2019,대전,질병,10,4,14
K60,2019,서울,질병,13,6,19
K60,2019,인천,질병,0,2,2
K60,2020,광주,질병,14,6,20
K60,2020,대구,질병,4,1,5
K60,2020,대전,질병,11,0,11
K60,2020,서울,질병,12,6,18
K60,2020,인천,질병,0,1,1
K60,2021,광주,질병,5,4,9
K60,2021,대구,질병,2,4,6
K60,2021,대전,질병,7,7,14
K60,2021,부산,질병,4,0,4
K60,2021,서울,질병,3,3,6
K60,2021,인천,질병,3,1,4
K60,2022,광주,질병,4,2,6
K60,2022,대구,질병,5,0,5
K60,2022,대전,질병,5,3,8
K60,2022,부산,질병,1,1,2
K60,2022,서울,질병,7,4,11
K60,2023,광주,질병,5,3,8
K60,2023,대구,질병,0,3,3
K60,2023,대전,질병,6,1,7
K60,2023,부산,질병,2,0,2
K60,2023,서울,질병,16,8,24
K61,2019,광주,질병,2,1,3
K61,2019,대구,질병,1,1,2
K61,2019,대전,질병,1,2,3
K61,2019,부산,질병,5,0,5
K61,2019,서울,질병,12,6,18
K61,2019,인천,질병,0,1,1
K61,2020,광주,질병,6,0,6
K61,2020,대전,질병,1,2,3
K61,2020,서울,질병,18,4,22
K61,2020,인천,질병,0,1,1
K61,2021,광주,질병,5,1,6
K61,2021,대구,질병,3,0,3
K61,2021,대전,질병,4,2,6
K61,2021,부산,질병,4,0,4
K61,2021,서울,질병,10,4,14
K61,2021,인천,질병,1,0,1
K61,2022,광주,질병,3,1,4
K61,2022,대구,질병,5,0,5
K61,2022,대전,질병,2,2,4
K61,2022,부산,질병,2,0,2
K61,2022,서울,질병,5,6,11
K61,2022,인천,질병,0,1,1
K61,2023,광주,질병,5,2,7
K61,2023,대구,질병,2,2,4
K61,2023,대전,질병,2,0,2
K61,2023,부산,질병,1,0,1
K61,2023,서울,질병,12,4,16
K62,2019,광주,질병,9,4,13
K62,2019,대구,질병,3,1,4
K62,2019,대전,질병,16,4,20
K62,2019,부산,질병,6,2,8
K62,2019,서울,질병,23,30,53
K62,2019,인천,질병,0,1,1
K62,2020,광주,질병,12,2,14
K62,2020,대구,질병,1,0,1
K62,2020,대전,질병,22,11,33
K62,2020,서울,질병,27,37,64
K62,2020,인천,질병,1,0,1
K62,2021,광주,질병,6,10,16
K62,2021,대구,질병,1,3,4
K62,2021,대전,질병,22,9,31
K62,2021,부산,질병,3,1,4
K62,2021,서울,질병,18,19,37
K62,2021,인천,질병,2,1,3
K62,2022,광주,질병,6,2,8
K62,2022,대구,질병,6,2,8
K62,2022,대전,질병,12,11,23
K62,2022,부산,질병,10,1,11
K62,2022,서울,질병,30,19,49
K62,2022,인천,질병,1,0,1
K62,2023,광주,질병,3,7,10
K62,2023,대구,질병,1,1,2
K62,2023,대전,질병,28,18,46
K62,2023,부산,질병,4,4,8
K62,2023,서울,질병,35,29,64
K63,2019,광주,질병,26,29,55
K63,2019,대구,질병,14,2,16
K63,2019,대전,질병,230,68,298
K63,2019,부산,질병,82,23,105
K63,2019,서울,질병,70,73,143
K63,2019,인천,질병,7,11,18
K63,2020,광주,질병,17,13,30
K63,2020,대구,질병,11,4,15
K63,2020,대전,질병,302,98,400
K63,2020,서울,질병,94,73,167
K63,2020,인천,질병,10,5,15
K63,2021,광주,질병,8,17,25
K63,2021,대구,질병,13,4,17
K63,2021,대전,질병,268,101,369
K63,2021,부산,질병,81,22,103
K63,2021,서울,질병,63,64,127
K63,2021,인천,질병,4,1,5
K63,2022,광주,질병,7,8,15
K63,2022,대구,질병,16,3,19
K63,2022,대전,질병,232,92,324
K63,2022,부산,질병,60,23,83
K63,2022,서울,질병,72,60,132
K63,2022,인천,질병,2,1,3
K63,2023,광주,질병,6,7,13
K63,2023,대구,질병,8,6,14
K63,2023,대전,질병,377,144,521
K63,2023,부산,질병,46,16,62
K63,2023,서울,질병,88,52,140
K64,2019,광주,질병,33,19,52
K64,2019,대구,질병,3,3,6
K64,2019,대전,질병,34,20,54
K64,2019,부산,질병,2,1,3
K64,2019,서울,질병,63,89,152
K64,2019,인천,질병,3,20,23
K64,2020,광주,질병,29,17,46
K64,2020,대구,질병,9,2,11
K64,2020,대전,질병,47,21,68
K64,2020,서울,질병,50,72,122
K64,2020,인천,질병,6,9,15
K64,2021,광주,질병,36,24,60
K64,2021,대구,질병,7,4,11
K64,2021,대전,질병,16,16,32
K64,2021,부산,질병,13,9,22
K64,2021,서울,질병,53,51,104
K64,2021,인천,질병,5,5,10
K64,2022,광주,질병,26,13,39
K64,2022,대구,질병,3,3,6
K64,2022,대전,질병,21,13,34
K64,2022,부산,질병,1,1,2
K64,2022,서울,질병,62,50,112
K64,2023,광주,질병,18,14,32
K64,2023,대구,질병,4,9,13
K64,2023,대전,질병,24,13,37
K64,2023,부산,질병,6,3,9
K64,2023,서울,질병,75,87,162
K64,2023,인천,질병,2,6,8
K65,2019,광주,질병,0,2,2
K65,2019,대구,질병,3,4,7
K65,2019,대전,질병,4,2,6
K65,2019,서울,질병,26,20,46
K65,2020,광주,질병,2,7,9
K65,2020,대구,질병,2,0,2
K65,2020,대전,질병,2,2,4
K65,2020,서울,질병,26,31,57
K65,2021,광주,질병,1,5,6
K65,2021,대구,질병,2,1,3
K65,2021,대전,질병,3,3,6
K65,2021,부산,질병,0,3,3
K65,2021,서울,질병,27,13,40
K65,2022,광주,질병,0,2,2
K65,2022,대구,질병,2,0,2
K65,2022,대전,질병,8,3,11
K65,2022,부산,질병,2,0,2
K65,2022,서울,질병,18,15,33
K65,2023,광주,질병,0,2,2
K65,2023,대구,질병,2,2,4
K65,2023,서울,질병,19,14,33
K66,2019,광주,질병,3,0,3
K66,2019,부산,질병,0,1,1
K66,2019,서울,질병,6,3,9
K66,2020,서울,질병,53,35,88
K66,2021,대구,질병,1,0,1
K66,2021,대전,질병,0,1,1
K66,2021,서울,질병,90,60,150
K66,2022,광주,질병,1,0,1
K66,2022,서울,질병,105,58,163
K66,2023,대구,질병,3,0,3
K66,2023,대전,질병,0,1,1
K66,2023,부산,질병,1,0,1
K66,2023,서울,질병,108,53,161
K67,2019,서울,질병,1,1,2
K67,2020,서울,질병,0,1,1
K70,2019,광주,질병,4,5,9
K70,2019,대구,질병,17,9,26
K70,2019,대전,질병,32,9,41
K70,2019,부산,질병,21,5,26
K70,2019,서울,질병,76,55,131
K70,2019,인천,질병,1,0,1
K70,2020,광주,질병,4,0,4
K70,2020,대구,질병,23,9,32
K70,2020,대전,질병,28,11,39
K70,2020,서울,질병,82,51,133
K70,2020,인천,질병,1,9,10
K70,2021,광주,질병,10,2,12
K70,2021,대구,질병,7,6,13
K70,2021,대전,질병,20,7,27
K70,2021,부산,질병,17,9,26
K70,2021,서울,질병,83,51,134
K70,2021,인천,질병,2,3,5
K70,2022,광주,질병,10,1,11
K70,2022,대구,질병,8,2,10
K70,2022,대전,질병,9,7,16
K70,2022,부산,질병,10,4,14
K70,2022,서울,질병,69,34,103
K70,2022,인천,질병,0,6,6
K70,2023,광주,질병,6,8,14
K70,2023,대구,질병,6,0,6
K70,2023,대전,질병,0,6,6
K70,2023,부산,질병,6,7,13
K70,2023,서울,질병,70,34,104
K70,2023,인천,질병,1,4,5
K71,2019,광주,질병,1,1,2
K71,2019,대구,질병,6,1,7
K71,2019,대전,질병,6,5,11
K71,2019,서울,질병,11,8,19
K71,2019,인천,질병,0,1,1
K71,2020,광주,질병,2,3,5
K71,2020,대구,질병,6,7,13
K71,2020,대전,질병,3,2,5
K71,2020,서울,질병,7,6,13
K71,2021,광주,질병,2,3,5
K71,2021,대구,질병,10,1,11
K71,2021,대전,질병,3,4,7
K71,2021,서울,질병,4,4,8
K71,2022,광주,질병,0,1,1
K71,2022,대구,질병,23,2,25
K71,2022,대전,질병,3,0,3
K71,2022,부산,질병,0,1,1
K71,2022,서울,질병,4,5,9
K71,2023,대구,질병,10,1,11
K71,2023,대전,질병,2,3,5
K71,2023,서울,질병,18,11,29
K72,2019,광주,질병,6,0,6
K72,2019,대구,질병,6,4,10
K72,2019,대전,질병,8,0,8
K72,2019,부산,질병,6,2,8
K72,2019,서울,질병,43,29,72
K72,2019,인천,질병,0,1,1
K72,2020,광주,질병,1,2,3
K72,2020,대구,질병,1,3,4
K72,2020,대전,질병,4,2,6
K72,2020,서울,질병,41,18,59
K72,2020,인천,질병,0,1,1
K72,2021,광주,질병,2,2,4
K72,2021,대구,질병,3,1,4
K72,2021,대전,질병,7,3,10
K72,2021,부산,질병,4,1,5
K72,2021,서울,질병,22,11,33
K72,2022,광주,질병,3,2,5
K72,2022,대구,질병,1,2,3
K72,2022,대전,질병,1,6,7
K72,2022,부산,질병,2,0,2
K72,2022,서울,질병,25,13,38
K72,2023,광주,질병,1,1,2
K72,2023,대구,질병,3,0,3
K72,2023,대전,질병,3,1,4
K72,2023,부산,질병,3,1,4
K72,2023,서울,질병,28,14,42
K72,2023,인천,질병,1,3,4
K73,2019,대구,질병,1,2,3
K73,2019,대전,질병,3,1,4
K73,2019,부산,질병,12,5,17
K73,2019,서울,질병,13,4,17
K73,2020,광주,질병,0,1,1
K73,2020,대구,질병,1,0,1
K73,2020,대전,질병,5,1,6
K73,2020,서울,질병,35,7,42
K73,2021,대전,질병,2,0,2
K73,2021,부산,질병,15,3,18
K73,2021,서울,질병,20,6,26
K73,2022,광주,질병,1,0,1
K73,2022,대구,질병,2,0,2
K73,2022,대전,질병,2,2,4
K73,2022,부산,질병,5,4,9
K73,2022,서울,질병,23,4,27
K73,2023,대전,질병,3,0,3
K73,2023,부산,질병,4,5,9
K73,2023,서울,질병,5,2,7
K74,2019,광주,질병,10,12,22
K74,2019,대구,질병,16,8,24
K74,2019,대전,질병,7,2,9
K74,2019,부산,질병,11,4,15
K74,2019,서울,질병,161,104,265
K74,2019,인천,질병,3,7,10
K74,2020,광주,질병,6,6,12
K74,2020,대구,질병,11,2,13
K74,2020,대전,질병,8,3,11
K74,2020,서울,질병,177,85,262
K74,2020,인천,질병,1,1,2
K74,2021,광주,질병,9,8,17
K74,2021,대구,질병,6,3,9
K74,2021,대전,질병,6,3,9
K74,2021,부산,질병,10,5,15
K74,2021,서울,질병,149,66,215
K74,2021,인천,질병,2,2,4
K74,2022,광주,질병,10,6,16
K74,2022,대구,질병,13,3,16
K74,2022,대전,질병,10,3,13
K74,2022,부산,질병,13,6,19
K74,2022,서울,질병,165,53,218
K74,2023,광주,질병,18,17,35
K74,2023,대구,질병,9,0,9
K74,2023,대전,질병,5,3,8
K74,2023,부산,질병,9,9,18
K74,2023,서울,질병,143,52,195
K74,2023,인천,질병,0,1,1
K75,2019,광주,질병,7,12,19
K75,2019,대구,질병,1,9,10
K75,2019,대전,질병,6,3,9
K75,2019,부산,질병,6,3,9
K75,2019,서울,질병,39,34,73
K75,2019,인천,질병,2,4,6
K75,2020,광주,질병,8,5,13
K75,2020,대구,질병,6,9,15
K75,2020,대전,질병,3,5,8
K75,2020,서울,질병,34,35,69
K75,2020,인천,질병,0,3,3
K75,2021,광주,질병,11,7,18
K75,2021,대구,질병,9,3,12
K75,2021,대전,질병,7,6,13
K75,2021,부산,질병,5,3,8
K75,2021,서울,질병,18,16,34
K75,2021,인천,질병,0,1,1
K75,2022,광주,질병,3,3,6
K75,2022,대구,질병,10,2,12
K75,2022,대전,질병,12,4,16
K75,2022,부산,질병,4,0,4
K75,2022,서울,질병,16,15,31
K75,2022,인천,질병,0,1,1
K75,2023,광주,질병,7,8,15
K75,2023,대구,질병,6,6,12
K75,2023,대전,질병,5,4,9
K75,2023,부산,질병,6,3,9
K75,2023,서울,질병,21,10,31
K76,2019,광주,질병,2,1,3
K76,2019,대구,질병,6,9,15
K76,2019,대전,질병,4,8,12
K76,2019,부산,질병,15,4,19
K76,2019,서울,질병,85,58,143
K76,2020,광주,질병,5,5,10
K76,2020,대구,질병,14,3,17
K76,2020,대전,질병,8,6,14
K76,2020,서울,질병,59,45,104
K76,2021,광주,질병,6,1,7
K76,2021,대구,질병,5,5,10
K76,2021,대전,질병,13,4,17
K76,2021,부산,질병,10,4,14
K76,2021,서울,질병,44,31,75
K76,2022,광주,질병,3,2,5
K76,2022,대구,질병,4,1,5
K76,2022,대전,질병,11,2,13
K76,2022,부산,질병,4,9,13
K76,2022,서울,질병,19,22,41
K76,2023,광주,질병,4,1,5
K76,2023,대구,질병,1,0,1
K76,2023,대전,질병,2,1,3
K76,2023,부산,질병,3,3,6
K76,2023,서울,질병,30,20,50
K77,2019,서울,질병,0,1,1
K77,2020,서울,질병,0,1,1
K77,2021,서울,질병,0,1,1
K77,2023,대전,질병,0,1,1
K80,2019,광주,질병,51,93,144
K80,2019,대구,질병,36,30,66
K80,2019,대전,질병,16,20,36
K80,2019,부산,질병,40,34,74
K80,2019,서울,질병,230,220,450
K80,2019,인천,질병,4,7,11
K80,2020,광주,질병,46,91,137
K80,2020,대구,질병,55,32,87
K80,2020,대전,질병,21,22,43
K80,2020,서울,질병,169,233,402
K80,2020,인천,질병,1,9,10
K80,2021,광주,질병,42,68,110
K80,2021,대구,질병,50,47,97
K80,2021,대전,질병,19,27,46
K80,2021,부산,질병,40,32,72
K80,2021,서울,질병,150,160,310
K80,2021,인천,질병,1,2,3
K80,2022,광주,질병,39,50,89
K80,2022,대구,질병,32,39,71
K80,2022,대전,질병,43,23,66
K80,2022,부산,질병,22,10,32
K80,2022,서울,질병,124,150,274
K80,2022,인천,질병,1,1,2
K80,2023,광주,질병,39,81,120
K80,2023,대구,질병,26,31,57
K80,2023,대전,질병,26,21,47
K80,2023,부산,질병,35,19,54
K80,2023,서울,질병,183,204,387
K80,2023,인천,질병,3,9,12
K81,2019,광주,질병,25,26,51
K81,2019,대구,질병,16,14,30
K81,2019,대전,질병,19,5,24
K81,2019,부산,질병,16,4,20
K81,2019,서울,질병,52,61,113
K81,2019,인천,질병,1,3,4
K81,2020,광주,질병,13,29,42
K81,2020,대구,질병,11,13,24
K81,2020,대전,질병,24,15,39
K81,2020,서울,질병,64,56,120
K81,2020,인천,질병,1,5,6
K81,2021,광주,질병,41,46,87
K81,2021,대구,질병,11,6,17
K81,2021,대전,질병,26,17,43
K81,2021,부산,질병,8,3,11
K81,2021,서울,질병,44,33,77
K81,2021,인천,질병,1,2,3
K81,2022,광주,질병,40,29,69
K81,2022,대구,질병,10,2,12
K81,2022,대전,질병,22,15,37
K81,2022,부산,질병,7,2,9
K81,2022,서울,질병,58,52,110
K81,2022,인천,질병,1,0,1
K81,2023,광주,질병,32,42,74
K81,2023,대구,질병,9,7,16
K81,2023,대전,질병,32,20,52
K81,2023,부산,질병,15,1,16
K81,2023,서울,질병,47,53,100
K81,2023,인천,질병,0,2,2
K82,2019,광주,질병,1,6,7
K82,2019,대구,질병,5,1,6
K82,2019,대전,질병,0,7,7
K82,2019,부산,질병,9,7,16
K82,2019,서울,질병,33,63,96
K82,2020,광주,질병,1,3,4
K82,2020,대구,질병,5,4,9
K82,2020,대전,질병,6,4,10
K82,2020,서울,질병,43,52,95
K82,2021,광주,질병,1,3,4
K82,2021,대구,질병,1,2,3
K82,2021,대전,질병,1,1,2
K82,2021,부산,질병,1,1,2
K82,2021,서울,질병,40,46,86
K82,2022,광주,질병,1,3,4
K82,2022,대구,질병,1,4,5
K82,2022,대전,질병,1,1,2
K82,2022,부산,질병,1,0,1
K82,2022,서울,질병,30,50,80
K82,2023,광주,질병,1,0,1
K82,2023,대구,질병,2,1,3
K82,2023,대전,질병,1,0,1
K82,2023,부산,질병,4,3,7
K82,2023,서울,질병,41,52,93
K83,2019,광주,질병,7,9,16
K83,2019,대구,질병,12,2,14
K83,2019,부산,질병,13,3,16
K83,2019,서울,질병,56,44,100
K83,2020,광주,질병,8,16,24
K83,2020,대구,질병,5,4,9
K83,2020,대전,질병,3,1,4
K83,2020,서울,질병,75,60,135
K83,2021,광주,질병,6,12,18
K83,2021,대구,질병,9,1,10
K83,2021,대전,질병,4,1,5
K83,2021,부산,질병,14,2,16
K83,2021,서울,질병,37,29,66
K83,2022,광주,질병,12,12,24
K83,2022,대구,질병,8,1,9
K83,2022,대전,질병,1,4,5
K83,2022,부산,질병,10,0,10
K83,2022,서울,질병,46,23,69
K83,2023,광주,질병,8,10,18
K83,2023,대구,질병,0,1,1
K83,2023,대전,질병,6,0,6
K83,2023,부산,질병,5,2,7
K83,2023,서울,질병,63,35,98
K85,2019,광주,질병,11,13,24
K85,2019,대구,질병,11,2,13
K85,2019,대전,질병,6,6,12
K85,2019,부산,질병,24,4,28
K85,2019,서울,질병,25,13,38
K85,2019,인천,질병,0,3,3
K85,2020,광주,질병,3,12,15
K85,2020,대구,질병,7,6,13
K85,2020,대전,질병,9,3,12
K85,2020,서울,질병,17,37,54
K85,2020,인천,질병,0,1,1
K85,2021,광주,질병,4,9,13
K85,2021,대구,질병,5,7,12
K85,2021,대전,질병,5,4,9
K85,2021,부산,질병,9,6,15
K85,2021,서울,질병,10,15,25
K85,2021,인천,질병,1,1,2
K85,2022,광주,질병,7,6,13
K85,2022,대구,질병,5,3,8
K85,2022,대전,질병,4,7,11
K85,2022,부산,질병,11,4,15
K85,2022,서울,질병,12,4,16
K85,2023,광주,질병,3,6,9
K85,2023,대구,질병,5,3,8
K85,2023,대전,질병,5,0,5
K85,2023,부산,질병,6,4,10
K85,2023,서울,질병,21,21,42
K85,2023,인천,질병,0,1,1
K86,2019,광주,질병,6,4,10
K86,2019,대구,질병,6,2,8
K86,2019,대전,질병,2,3,5
K86,2019,부산,질병,2,3,5
K86,2019,서울,질병,11,13,24
K86,2019,인천,질병,0,1,1
K86,2020,광주,질병,12,2,14
K86,2020,대구,질병,6,0,6
K86,2020,대전,질병,1,0,1
K86,2020,서울,질병,18,17,35
K86,2021,광주,질병,6,2,8
K86,2021,대구,질병,6,3,9
K86,2021,대전,질병,3,1,4
K86,2021,부산,질병,4,1,5
K86,2021,서울,질병,5,5,10
K86,2021,인천,질병,0,1,1
K86,2022,광주,질병,10,0,10
K86,2022,대구,질병,8,2,10
K86,2022,대전,질병,3,0,3
K86,2022,부산,질병,5,5,10
K86,2022,서울,질병,4,4,8
K86,2023,광주,질병,8,3,11
K86,2023,대구,질병,7,0,7
K86,2023,대전,질병,1,0,1
K86,2023,부산,질병,5,8,13
K86,2023,서울,질병,7,11,18
K86,2023,인천,질병,1,0,1
K90,2019,서울,질병,2,0,2
K90,2020,대전,질병,0,1,1
K90,2020,서울,질병,1,1,2
K91,2019,광주,질병,1,1,2
K91,2019,대구,질병,5,0,5
K91,2019,대전,질병,2,3,5
K91,2019,부산,질병,7,0,7
K91,2019,서울,질병,89,60,149
K91,2020,광주,질병,2,1,3
K91,2020,대구,질병,11,0,11
K91,2020,대전,질병,3,2,5
K91,2020,서울,질병,77,52,129
K91,2021,광주,질병,2,0,2
K91,2021,대구,질병,2,0,2
K91,2021,대전,질병,6,1,7
K91,2021,부산,질병,5,0,5
K91,2021,서울,질병,77,43,120
K91,2022,광주,질병,1,0,1
K91,2022,대구,질병,1,0,1
K91,2022,대전,질병,2,1,3
K91,2022,부산,질병,4,2,6
K91,2022,서울,질병,79,41,120
K91,2023,대구,질병,1,7,8
K91,2023,대전,질병,6,0,6
K91,2023,부산,질병,5,0,5
K91,2023,서울,질병,86,28,114
K92,2019,광주,질병,13,7,20
K92,2019,대구,질병,13,9,22
K92,2019,대전,질병,6,4,10
K92,2019,부산,질병,34,7,41
K92,2019,서울,질병,74,50,124
K92,2019,인천,질병,0,3,3
K92,2020,광주,질병,11,9,20
K92,2020,대구,질병,10,3,13
K92,2020,대전,질병,10,6,16
K92,2020,서울,질병,56,47,103
K92,2020,인천,질병,0,2,2
K92,2021,광주,질병,9,6,15
K92,2021,대구,질병,10,4,14
K92,2021,대전,질병,12,7,19
K92,2021,부산,질병,40,11,51
K92,2021,서울,질병,43,36,79
K92,2021,인천,질병,0,1,1
K92,2022,광주,질병,5,5,10
K92,2022,대구,질병,11,9,20
K92,2022,대전,질병,6,4,10
K92,2022,부산,질병,16,3,19
K92,2022,서울,질병,63,32,95
K92,2023,광주,질병,7,8,15
K92,2023,대구,질병,11,6,17
K92,2023,대전,질병,4,5,9
K92,2023,부산,질병,23,5,28
K92,2023,서울,질병,46,38,84
K93,2019,서울,질병,1,0,1
K93,2023,서울,질병,0,2,2
L00,2019,광주,질병,0,1,1
L00,2020,광주,질병,0,1,1
L00,2022,광주,질병,0,1,1
L01,2019,광주,질병,0,1,1
L01,2019,서울,질병,2,0,2
L01,2022,서울,질병,1,0,1
L02,2019,광주,질병,5,2,7
L02,2019,대구,질병,6,2,8
L02,2019,대전,질병,6,0,6
L02,2019,부산,질병,3,2,5
L02,2019,서울,질병,33,15,48
L02,2020,광주,질병,6,3,9
L02,2020,대구,질병,9,4,13
L02,2020,대전,질병,8,0,8
L02,2020,서울,질병,26,13,39
L02,2021,대구,질병,6,2,8
L02,2021,대전,질병,3,4,7
L02,2021,부산,질병,8,2,10
L02,2021,서울,질병,23,18,41
L02,2021,인천,질병,0,2,2
L02,2022,광주,질병,5,2,7
L02,2022,대구,질병,4,2,6
L02,2022,대전,질병,2,1,3
L02,2022,부산,질병,1,0,1
L02,2022,서울,질병,25,21,46
L02,2023,광주,질병,5,5,10
L02,2023,대구,질병,7,2,9
L02,2023,대전,질병,5,0,5
L02,2023,부산,질병,0,1,1
L02,2023,서울,질병,26,21,47
L02,2023,인천,질병,1,0,1
L03,2019,광주,질병,29,17,46
L03,2019,대구,질병,23,21,44
L03,2019,대전,질병,20,8,28
L03,2019,부산,질병,22,3,25
L03,2019,서울,질병,94,34,128
L03,2019,인천,질병,2,4,6
L03,2020,광주,질병,17,15,32
L03,2020,대구,질병,30,8,38
L03,2020,대전,질병,14,11,25
L03,2020,서울,질병,63,45,108
L03,2020,인천,질병,5,1,6
L03,2021,광주,질병,22,19,41
L03,2021,대구,질병,15,10,25
L03,2021,대전,질병,17,11,28
L03,2021,부산,질병,20,5,25
L03,2021,서울,질병,43,30,73
L03,2021,인천,질병,3,1,4
L03,2022,광주,질병,22,7,29
L03,2022,대구,질병,20,8,28
L03,2022,대전,질병,22,12,34
L03,2022,부산,질병,14,4,18
L03,2022,서울,질병,54,41,95
L03,2022,인천,질병,0,1,1
L03,2023,광주,질병,22,20,42
L03,2023,대구,질병,24,14,38
L03,2023,대전,질병,29,13,42
L03,2023,부산,질병,19,4,23
L03,2023,서울,질병,64,44,108
L03,2023,인천,질병,0,2,2
L04,2019,광주,질병,0,3,3
L04,2019,서울,질병,0,1,1
L04,2020,광주,질병,0,4,4
L04,2021,서울,질병,1,0,1
L04,2022,서울,질병,1,0,1
L04,2023,서울,질병,1,1,2
L05,2019,광주,질병,1,0,1
L05,2020,광주,질병,0,2,2
L05,2020,대구,질병,0,1,1
L05,2020,서울,질병,0,1,1
L05,2020,인천,질병,0,1,1
L05,2021,광주,질병,1,1,2
L05,2021,서울,질병,0,2,2
L05,2023,광주,질병,1,0,1
L08,2019,광주,질병,0,1,1
L08,2019,대구,질병,1,0,1
L08,2019,서울,질병,6,3,9
L08,2020,대구,질병,1,0,1
L08,2020,서울,질병,3,2,5
L08,2021,서울,질병,1,4,5
L08,2022,대전,질병,1,0,1
L08,2022,서울,질병,3,1,4
L08,2023,대구,질병,2,0,2
L08,2023,부산,질병,1,0,1
L08,2023,서울,질병,5,4,9
L10,2019,서울,질병,0,1,1
L10,2020,서울,질병,0,4,4
L10,2023,서울,질병,1,0,1
L11,2021,서울,질병,1,0,1
L12,2019,대전,질병,0,3,3
L12,2019,서울,질병,6,2,8
L12,2020,대전,질병,1,0,1
L12,2020,서울,질병,5,1,6
L12,2021,대전,질병,0,2,2
L12,2021,서울,질병,5,0,5
L12,2022,대전,질병,1,0,1
L12,2022,서울,질병,1,2,3
L12,2023,서울,질병,2,1,3
L13,2019,서울,질병,2,3,5
L13,2020,서울,질병,2,1,3
L13,2023,서울,질병,2,0,2
L20,2019,광주,질병,0,1,1
L20,2019,대전,질병,0,1,1
L20,2019,부산,질병,1,3,4
L20,2019,서울,질병,3,4,7
L20,2020,서울,질병,7,5,12
L20,2021,광주,질병,0,1,1
L20,2021,서울,질병,1,2,3
L20,2022,부산,질병,3,1,4
L20,2022,서울,질병,3,2,5
L20,2023,대전,질병,0,1,1
L20,2023,서울,질병,4,2,6
L21,2019,대구,질병,1,0,1
L21,2019,대전,질병,31,11,42
L21,2019,서울,질병,29,20,49
L21,2020,대전,질병,23,4,27
L21,2020,서울,질병,30,11,41
L21,2021,대전,질병,26,4,30
L21,2021,서울,질병,20,9,29
L21,2022,대전,질병,10,4,14
L21,2022,서울,질병,30,5,35
L21,2023,대전,질병,6,2,8
L21,2023,서울,질병,57,24,81
L22,2019,대전,질병,1,3,4
L22,2019,서울,질병,1,4,5
L22,2020,대전,질병,2,2,4
L22,2020,서울,질병,7,5,12
L22,2021,대전,질병,1,6,7
L22,2021,서울,질병,1,4,5
L22,2022,대전,질병,2,1,3
L22,2022,서울,질병,6,6,12
L22,2023,서울,질병,24,27,51
L23,2019,대구,질병,0,1,1
L23,2019,대전,질병,2,4,6
L23,2019,부산,질병,2,0,2
L23,2019,서울,질병,13,8,21
L23,2020,대전,질병,3,4,7
L23,2020,서울,질병,5,1,6
L23,2020,인천,질병,1,0,1
L23,2021,대전,질병,11,10,21
L23,2021,부산,질병,1,0,1
L23,2021,서울,질병,8,16,24
L23,2022,대전,질병,4,3,7
L23,2022,서울,질병,15,8,23
L23,2023,대전,질병,5,4,9
L23,2023,서울,질병,14,12,26
L24,2019,대구,질병,1,0,1
L24,2019,대전,질병,2,0,2
L24,2019,서울,질병,14,12,26
L24,2020,서울,질병,8,11,19
L24,2021,서울,질병,20,14,34
L24,2022,서울,질병,5,11,16
L24,2023,서울,질병,11,15,26
L25,2019,대전,질병,0,1,1
L25,2019,부산,질병,1,0,1
L25,2019,서울,질병,6,2,8
L25,2020,대전,질병,1,0,1
L25,2020,서울,질병,12,0,12
L25,2021,서울,질병,6,5,11
L25,2022,대전,질병,0,1,1
L25,2022,서울,질병,13,26,39
L25,2023,서울,질병,12,16,28
L26,2022,서울,질병,3,0,3
L27,2019,대구,질병,3,1,4
L27,2019,대전,질병,1,0,1
L27,2019,서울,질병,17,16,33
L27,2020,대구,질병,2,4,6
L27,2020,대전,질병,0,1,1
L27,2020,서울,질병,23,11,34
L27,2021,부산,질병,1,0,1
L27,2021,서울,질병,18,15,33
L27,2022,서울,질병,23,23,46
L27,2023,대구,질병,0,2,2
L27,2023,대전,질병,1,0,1
L27,2023,서울,질병,32,28,60
L28,2019,대전,질병,10,1,11
L28,2019,서울,질병,22,6,28
L28,2020,대전,질병,4,0,4
L28,2020,서울,질병,16,8,24
L28,2021,대전,질병,4,0,4
L28,2021,서울,질병,19,4,23
L28,2022,대구,질병,1,0,1
L28,2022,대전,질병,3,0,3
L28,2022,서울,질병,15,11,26
L28,2023,대전,질병,1,1,2
L28,2023,서울,질병,17,20,37
L29,2019,대전,질병,105,30,135
L29,2019,부산,질병,1,0,1
L29,2019,서울,질병,40,25,65
L29,2019,인천,질병,0,1,1
L29,2020,대구,질병,1,1,2
L29,2020,대전,질병,79,30,109
L29,2020,서울,질병,52,28,80
L29,2020,인천,질병,3,1,4
L29,2021,광주,질병,0,2,2
L29,2021,대구,질병,1,0,1
L29,2021,대전,질병,96,24,120
L29,2021,부산,질병,0,3,3
L29,2021,서울,질병,41,34,75
L29,2022,대전,질병,50,11,61
L29,2022,서울,질병,28,15,43
L29,2023,대전,질병,23,8,31
L29,2023,서울,질병,60,26,86
L30,2019,광주,질병,0,1,1
L30,2019,대전,질병,5,1,6
L30,2019,부산,질병,1,0,1
L30,2019,서울,질병,34,12,46
L30,2020,대구,질병,1,0,1
L30,2020,대전,질병,2,1,3
L30,2020,서울,질병,35,19,54
L30,2021,대전,질병,1,0,1
L30,2021,부산,질병,0,3,3
L30,2021,서울,질병,12,10,22
L30,2022,대전,질병,3,4,7
L30,2022,서울,질병,30,25,55
L30,2023,대구,질병,0,1,1
L30,2023,대전,질병,1,0,1
L30,2023,서울,질병,30,26,56
L40,2019,대전,질병,0,1,1
L40,2019,서울,질병,14,1,15
L40,2020,서울,질병,4,2,6
L40,2021,대구,질병,1,0,1
L40,2021,서울,질병,8,3,11
L40,2022,대전,질병,1,0,1
L40,2022,서울,질병,4,4,8
L40,2023,대구,질병,1,0,1
L40,2023,부산,질병,1,0,1
L40,2023,서울,질병,5,3,8
L41,2021,서울,질병,0,2,2
L41,2023,서울,질병,0,1,1
L42,2019,서울,질병,0,1,1
L42,2023,서울,질병,3,0,3
L43,2020,서울,질병,0,1,1
L43,2021,서울,질병,1,0,1
L44,2020,서울,질병,0,1,1
L50,2019,광주,질병,0,9,9
L50,2019,대전,질병,5,3,8
L50,2019,서울,질병,10,11,21
L50,2019,인천,질병,0,1,1
L50,2020,광주,질병,1,2,3
L50,2020,대구,질병,1,0,1
L50,2020,대전,질병,5,0,5
L50,2020,서울,질병,22,10,32
L50,2020,인천,질병,2,0,2
L50,2021,광주,질병,0,1,1
L50,2021,대전,질병,2,1,3
L50,2021,서울,질병,11,28,39
L50,2022,광주,질병,0,1,1
L50,2022,대구,질병,1,0,1
L50,2022,대전,질병,1,0,1
L50,2022,서울,질병,20,19,39
L50,2022,인천,질병,0,1,1
L50,2023,대전,질병,1,0,1
L50,2023,서울,질병,17,18,35
L51,2019,광주,질병,0,1,1
L51,2019,서울,질병,2,3,5
L51,2020,서울,질병,2,0,2
L51,2021,서울,질병,2,0,2
L51,2022,서울,질병,2,1,3
L51,2023,광주,질병,0,1,1
L51,2023,서울,질병,9,3,12
L52,2019,대구,질병,0,1,1
L52,2019,서울,질병,1,0,1
L53,2019,서울,질병,2,0,2
L53,2020,서울,질병,4,1,5
L53,2021,서울,질병,2,5,7
L53,2022,서울,질병,6,3,9
L53,2023,서울,질병,5,4,9
L55,2022,대전,질병,0,1,1
L55,2023,서울,질병,0,3,3
L56,2019,서울,질병,1,0,1
L56,2020,서울,질병,0,1,1
L56,2021,대전,질병,0,1,1
L56,2021,서울,질병,1,0,1
L56,2022,대전,질병,1,0,1
L56,2022,서울,질병,1,1,2
L56,2023,서울,질병,0,1,1
L57,2019,대전,질병,2,0,2
L57,2019,서울,질병,9,2,11
L57,2020,서울,질병,8,4,12
L57,2021,서울,질병,3,0,3
L57,2022,서울,질병,4,3,7
L57,2023,서울,질병,14,4,18
L58,2019,서울,질병,2,0,2
L58,2021,서울,질병,2,0,2
L58,2023,서울,질병,1,1,2
L59,2019,대전,질병,1,0,1
L59,2019,서울,질병,1,1,2
L59,2020,광주,질병,0,1,1
L59,2020,서울,질병,1,0,1
L59,2021,대전,질병,1,0,1
L59,2023,서울,질병,1,2,3
L60,2019,광주,질병,1,0,1
L60,2019,대구,질병,10,1,11
L60,2019,대전,질병,6,7,13
L60,2019,부산,질병,6,0,6
L60,2019,서울,질병,12,10,22
L60,2020,광주,질병,3,2,5
L60,2020,대구,질병,6,2,8
L60,2020,대전,질병,6,2,8
L60,2020,서울,질병,15,6,21
L60,2020,인천,질병,1,2,3
L60,2021,대구,질병,7,1,8
L60,2021,대전,질병,4,8,12
L60,2021,부산,질병,7,2,9
L60,2021,서울,질병,11,8,19
L60,2022,광주,질병,1,2,3
L60,2022,대구,질병,2,2,4
L60,2022,대전,질병,3,4,7
L60,2022,부산,질병,3,1,4
L60,2022,서울,질병,10,7,17
L60,2022,인천,질병,1,1,2
L60,2023,대구,질병,5,1,6
L60,2023,대전,질병,6,2,8
L60,2023,부산,질병,3,0,3
L60,2023,서울,질병,11,6,17
L60,2023,인천,질병,1,1,2
L63,2019,서울,질병,1,0,1
L63,2020,서울,질병,2,0,2
L63,2021,서울,질병,1,0,1
L63,2022,서울,질병,0,1,1
L63,2023,서울,질병,2,0,2
L65,2022,서울,질병,2,0,2
L66,2020,서울,질병,2,0,2
L66,2021,서울,질병,0,1,1
L66,2022,서울,질병,2,0,2
L66,2023,서울,질병,2,0,2
L67,2021,서울,질병,1,0,1
L70,2019,대전,질병,1,0,1
L70,2021,서울,질병,0,4,4
L70,2023,서울,질병,0,1,1
L71,2019,서울,질병,1,1,2
L71,2020,서울,질병,0,1,1
L71,2021,서울,질병,1,1,2
L71,2023,서울,질병,0,2,2
L72,2019,광주,질병,3,0,3
L72,2019,대구,질병,10,0,10
L72,2019,대전,질병,8,2,10
L72,2019,부산,질병,8,1,9
L72,2019,서울,질병,32,22,54
L72,2019,인천,질병,0,1,1
L72,2020,광주,질병,5,2,7
L72,2020,대구,질병,5,3,8
L72,2020,대전,질병,6,3,9
L72,2020,서울,질병,19,15,34
L72,2021,광주,질병,2,1,3
L72,2021,대구,질병,11,1,12
L72,2021,대전,질병,4,1,5
L72,2021,부산,질병,15,1,16
L72,2021,서울,질병,23,17,40
L72,2021,인천,질병,3,4,7
L72,2022,광주,질병,0,3,3
L72,2022,대구,질병,7,1,8
L72,2022,대전,질병,3,1,4
L72,2022,부산,질병,11,0,11
L72,2022,서울,질병,14,13,27
L72,2022,인천,질병,1,5,6
L72,2023,광주,질병,1,2,3
L72,2023,대구,질병,4,1,5
L72,2023,대전,질병,3,1,4
L72,2023,부산,질병,7,0,7
L72,2023,서울,질병,21,21,42
L72,2023,인천,질병,0,1,1
L73,2019,대전,질병,3,0,3
L73,2019,서울,질병,3,0,3
L73,2020,대전,질병,4,0,4
L73,2020,서울,질병,0,2,2
L73,2020,인천,질병,0,2,2
L73,2021,대구,질병,1,0,1
L73,2021,서울,질병,5,1,6
L73,2022,서울,질병,3,0,3
L73,2023,광주,질병,0,1,1
L73,2023,대전,질병,3,0,3
L73,2023,서울,질병,5,0,5
L74,2019,서울,질병,1,2,3
L74,2023,서울,질병,2,1,3
L80,2019,대구,질병,1,0,1
L80,2019,서울,질병,0,1,1
L80,2020,서울,질병,1,0,1
L80,2021,서울,질병,3,0,3
L80,2022,서울,질병,0,1,1
L80,2023,서울,질병,3,2,5
L81,2019,서울,질병,2,3,5
L81,2020,서울,질병,1,1,2
L81,2021,서울,질병,1,2,3
L81,2022,서울,질병,2,4,6
L81,2023,서울,질병,7,1,8
L82,2019,대전,질병,6,3,9
L82,2019,서울,질병,10,7,17
L82,2020,대구,질병,1,0,1
L82,2020,대전,질병,4,5,9
L82,2020,서울,질병,12,3,15
L82,2021,대구,질병,0,1,1
L82,2021,대전,질병,7,0,7
L82,2021,서울,질병,9,5,14
L82,2022,대전,질병,8,0,8
L82,2022,서울,질병,12,3,15
L82,2023,대전,질병,0,2,2
L82,2023,서울,질병,32,7,39
L83,2019,서울,질병,1,2,3
L83,2020,서울,질병,1,2,3
L83,2021,서울,질병,0,3,3
L83,2023,서울,질병,1,0,1
L84,2019,대전,질병,3,1,4
L84,2019,부산,질병,3,0,3
L84,2019,서울,질병,3,3,6
L84,2019,인천,질병,0,1,1
L84,2020,대구,질병,1,0,1
L84,2020,대전,질병,2,2,4
L84,2020,서울,질병,7,0,7
L84,2021,대구,질병,1,0,1
L84,2021,대전,질병,4,0,4
L84,2021,부산,질병,3,1,4
L84,2021,서울,질병,2,7,9
L84,2022,대구,질병,2,0,2
L84,2022,대전,질병,3,0,3
L84,2022,부산,질병,1,0,1
L84,2022,서울,질병,4,9,13
L84,2023,대구,질병,2,1,3
L84,2023,대전,질병,3,0,3
L84,2023,부산,질병,3,0,3
L84,2023,서울,질병,10,8,18
L85,2019,대전,질병,15,5,20
L85,2019,서울,질병,54,27,81
L85,2020,대전,질병,7,1,8
L85,2020,서울,질병,37,18,55
L85,2021,대전,질병,2,0,2
L85,2021,서울,질병,29,18,47
L85,2022,대전,질병,7,0,7
L85,2022,서울,질병,65,44,109
L85,2023,대전,질병,1,0,1
L85,2023,서울,질병,43,19,62
L86,2019,서울,질병,2,0,2
L87,2021,서울,질병,1,0,1
L87,2022,서울,질병,1,0,1
L88,2020,서울,질병,0,1,1
L88,2023,서울,질병,0,1,1
L89,2019,광주,질병,8,8,16
L89,2019,대구,질병,4,4,8
L89,2019,대전,질병,13,12,25
L89,2019,부산,질병,11,4,15
L89,2019,서울,질병,276,175,451
L89,2020,광주,질병,12,4,16
L89,2020,대구,질병,5,2,7
L89,2020,대전,질병,11,12,23
L89,2020,서울,질병,335,237,572
L89,2020,인천,질병,1,0,1
L89,2021,광주,질병,11,14,25
L89,2021,대구,질병,4,6,10
L89,2021,대전,질병,13,5,18
L89,2021,부산,질병,0,1,1
L89,2021,서울,질병,188,137,325
L89,2021,인천,질병,3,0,3
L89,2022,광주,질병,9,5,14
L89,2022,대구,질병,6,4,10
L89,2022,대전,질병,11,1,12
L89,2022,서울,질병,266,161,427
L89,2023,광주,질병,9,4,13
L89,2023,대구,질병,11,3,14
L89,2023,대전,질병,10,5,15
L89,2023,부산,질병,0,1,1
L89,2023,서울,질병,276,239,515
L90,2019,대구,질병,1,0,1
L90,2019,부산,질병,1,0,1
L90,2019,서울,질병,1,0,1
L90,2020,서울,질병,1,4,5
L90,2021,서울,질병,4,4,8
L90,2022,서울,질병,0,5,5
L90,2022,인천,질병,0,1,1
L90,2023,대구,질병,1,0,1
L90,2023,서울,질병,1,6,7
L91,2019,서울,질병,1,3,4
L91,2020,서울,질병,6,5,11
L91,2021,서울,질병,4,1,5
L91,2022,서울,질병,3,1,4
L91,2023,광주,질병,0,1,1
L91,2023,서울,질병,5,1,6
L92,2019,광주,질병,1,0,1
L92,2019,대구,질병,1,0,1
L92,2019,서울,질병,2,1,3
L92,2020,광주,질병,1,1,2
L92,2020,대전,질병,0,1,1
L92,2020,서울,질병,2,4,6
L92,2021,광주,질병,1,0,1
L92,2021,대구,질병,0,1,1
L92,2021,서울,질병,3,2,5
L92,2022,광주,질병,0,1,1
L92,2022,서울,질병,4,2,6
L92,2023,광주,질병,1,0,1
L92,2023,부산,질병,0,1,1
L92,2023,서울,질병,1,1,2
L93,2019,서울,질병,1,0,1
L93,2021,광주,질병,0,1,1
L93,2023,대구,질병,2,0,2
L94,2019,서울,질병,1,2,3
L94,2020,서울,질병,2,0,2
L94,2021,서울,질병,1,0,1
L94,2022,서울,질병,0,2,2
L95,2019,서울,질병,5,1,6
L95,2020,서울,질병,1,0,1
L95,2021,서울,질병,3,3,6
L95,2022,서울,질병,1,0,1
L95,2023,서울,질병,3,1,4
L97,2019,대구,질병,2,0,2
L97,2019,부산,질병,2,0,2
L97,2019,서울,질병,3,0,3
L97,2020,대구,질병,0,1,1
L97,2020,서울,질병,2,1,3
L97,2021,광주,질병,0,1,1
L97,2021,대구,질병,1,1,2
L97,2021,부산,질병,1,0,1
L97,2021,서울,질병,1,0,1
L97,2022,대구,질병,1,0,1
L97,2022,부산,질병,2,0,2
L97,2022,서울,질병,2,0,2
L97,2023,광주,질병,3,0,3
L97,2023,대구,질병,1,0,1
L97,2023,대전,질병,1,0,1
L98,2019,광주,질병,0,1,1
L98,2019,대구,질병,2,1,3
L98,2019,대전,질병,4,0,4
L98,2019,부산,질병,2,0,2
L98,2019,서울,질병,7,3,10
L98,2019,인천,질병,0,1,1
L98,2020,대구,질병,0,3,3
L98,2020,대전,질병,4,0,4
L98,2020,서울,질병,20,10,30
L98,2021,광주,질병,0,1,1
L98,2021,대구,질병,0,1,1
L98,2021,대전,질병,3,0,3
L98,2021,서울,질병,15,9,24
L98,2021,인천,질병,0,1,1
L98,2022,광주,질병,0,3,3
L98,2022,대구,질병,3,0,3
L98,2022,대전,질병,3,1,4
L98,2022,서울,질병,12,13,25
L98,2022,인천,질병,1,0,1
L98,2023,광주,질병,3,4,7
L98,2023,대구,질병,4,3,7
L98,2023,대전,질병,3,1,4
L98,2023,서울,질병,12,10,22
L98,2023,인천,질병,2,0,2
L99,2019,서울,질병,2,0,2
L99,2021,서울,질병,4,0,4
L99,2022,서울,질병,1,0,1
L99,2023,서울,질병,0,2,2
M00,2019,광주,질병,5,8,13
M00,2019,대구,질병,5,5,10
M00,2019,대전,질병,5,4,9
M00,2019,부산,질병,5,0,5
M00,2019,서울,질병,19,18,37
M00,2019,인천,질병,0,5,5
M00,2020,광주,질병,3,6,9
M00,2020,대구,질병,11,7,18
M00,2020,대전,질병,1,4,5
M00,2020,서울,질병,22,13,35
M00,2020,인천,질병,0,6,6
M00,2021,광주,질병,5,13,18
M00,2021,대구,질병,8,5,13
M00,2021,대전,질병,2,5,7
M00,2021,부산,질병,7,3,10
M00,2021,서울,질병,17,13,30
M00,2021,인천,질병,0,4,4
M00,2022,광주,질병,1,4,5
M00,2022,대구,질병,5,3,8
M00,2022,대전,질병,0,1,1
M00,2022,부산,질병,7,0,7
M00,2022,서울,질병,10,18,28
M00,2023,대구,질병,5,2,7
M00,2023,대전,질병,0,2,2
M00,2023,부산,질병,6,1,7
M00,2023,서울,질병,19,19,38
M02,2021,광주,질병,0,1,1
M02,2022,서울,질병,0,1,1
M05,2019,대전,질병,1,8,9
M05,2019,부산,질병,2,2,4
M05,2019,서울,질병,7,14,21
M05,2020,광주,질병,1,0,1
M05,2020,대구,질병,0,1,1
M05,2020,대전,질병,0,4,4
M05,2020,서울,질병,5,9,14
M05,2021,대전,질병,1,5,6
M05,2021,서울,질병,5,7,12
M05,2021,인천,질병,0,3,3
M05,2022,광주,질병,0,1,1
M05,2022,대구,질병,4,1,5
M05,2022,대전,질병,0,5,5
M05,2022,서울,질병,5,18,23
M05,2022,인천,질병,0,4,4
M05,2023,광주,질병,0,1,1
M05,2023,대구,질병,4,2,6
M05,2023,대전,질병,3,3,6
M05,2023,부산,질병,4,0,4
M05,2023,서울,질병,7,5,12
M06,2019,대구,질병,0,2,2
M06,2019,대전,질병,0,3,3
M06,2019,서울,질병,14,9,23
M06,2020,광주,질병,2,0,2
M06,2020,대구,질병,0,1,1
M06,2020,서울,질병,5,5,10
M06,2020,인천,질병,0,1,1
M06,2021,대구,질병,1,0,1
M06,2021,대전,질병,0,2,2
M06,2021,서울,질병,7,6,13
M06,2022,서울,질병,6,14,20
M06,2023,대전,질병,0,1,1
M06,2023,부산,질병,1,0,1
M06,2023,서울,질병,8,9,17
M07,2023,대구,질병,1,0,1
M08,2021,서울,질병,0,3,3
M10,2019,광주,질병,5,1,6
M10,2019,대구,질병,10,5,15
M10,2019,대전,질병,15,5,20
M10,2019,부산,질병,11,0,11
M10,2019,서울,질병,55,37,92
M10,2019,인천,질병,1,0,1
M10,2020,광주,질병,2,1,3
M10,2020,대구,질병,9,7,16
M10,2020,대전,질병,7,6,13
M10,2020,서울,질병,39,25,64
M10,2020,인천,질병,0,1,1
M10,2021,광주,질병,4,4,8
M10,2021,대구,질병,10,7,17
M10,2021,대전,질병,6,2,8
M10,2021,부산,질병,9,0,9
M10,2021,서울,질병,23,13,36
M10,2021,인천,질병,0,2,2
M10,2022,광주,질병,2,1,3
M10,2022,대구,질병,12,1,13
M10,2022,대전,질병,2,2,4
M10,2022,부산,질병,8,1,9
M10,2022,서울,질병,27,22,49
M10,2023,광주,질병,8,2,10
M10,2023,대구,질병,6,3,9
M10,2023,대전,질병,3,2,5
M10,2023,부산,질병,5,1,6
M10,2023,서울,질병,46,23,69
M11,2019,서울,질병,0,1,1
M11,2020,서울,질병,0,3,3
M11,2021,서울,질병,1,1,2
M11,2022,대구,질병,1,0,1
M11,2023,서울,질병,4,3,7
M12,2019,서울,질병,4,1,5
M12,2019,인천,질병,0,1,1
M12,2020,광주,질병,1,0,1
M12,2020,서울,질병,2,3,5
M12,2021,대구,질병,2,0,2
M12,2021,부산,질병,5,3,8
M12,2022,부산,질병,5,2,7
M12,2022,서울,질병,2,7,9
M12,2023,광주,질병,0,1,1
M12,2023,서울,질병,2,1,3
M13,2019,광주,질병,13,4,17
M13,2019,대구,질병,19,2,21
M13,2019,대전,질병,29,4,33
M13,2019,부산,질병,7,0,7
M13,2019,서울,질병,34,18,52
M13,2020,광주,질병,12,4,16
M13,2020,대구,질병,3,2,5
M13,2020,대전,질병,15,2,17
M13,2020,서울,질병,26,29,55
M13,2020,인천,질병,0,1,1
M13,2021,광주,질병,6,3,9
M13,2021,대구,질병,2,1,3
M13,2021,대전,질병,21,6,27
M13,2021,부산,질병,3,1,4
M13,2021,서울,질병,13,24,37
M13,2022,광주,질병,8,5,13
M13,2022,대전,질병,19,6,25
M13,2022,부산,질병,5,1,6
M13,2022,서울,질병,3,9,12
M13,2023,광주,질병,13,9,22
M13,2023,대구,질병,1,1,2
M13,2023,대전,질병,21,4,25
M13,2023,부산,질병,5,1,6
M13,2023,서울,질병,7,5,12
M13,2023,인천,질병,1,0,1
M14,2022,서울,질병,0,1,1
M14,2023,서울,질병,1,0,1
M15,2019,대전,질병,43,5,48
M15,2019,부산,질병,34,2,36
M15,2019,서울,질병,16,3,19
M15,2020,광주,질병,1,0,1
M15,2020,대구,질병,4,0,4
M15,2020,대전,질병,33,6,39
M15,2020,서울,질병,5,3,8
M15,2021,대구,질병,2,0,2
M15,2021,대전,질병,41,8,49
M15,2021,부산,질병,20,2,22
M15,2021,서울,질병,2,0,2
M15,2022,대구,질병,2,0,2
M15,2022,대전,질병,37,1,38
M15,2022,부산,질병,16,3,19
M15,2022,서울,질병,1,1,2
M15,2023,광주,질병,1,0,1
M15,2023,대구,질병,1,0,1
M15,2023,대전,질병,58,6,64
M15,2023,부산,질병,17,1,18
M15,2023,서울,질병,1,0,1
M15,2023,인천,질병,1,0,1
M16,2019,광주,질병,1,1,2
M16,2019,대구,질병,0,1,1
M16,2019,대전,질병,1,4,5
M16,2019,부산,질병,24,7,31
M16,2019,서울,질병,4,7,11
M16,2019,인천,질병,0,1,1
M16,2020,대구,질병,1,1,2
M16,2020,대전,질병,3,1,4
M16,2020,서울,질병,3,9,12
M16,2020,인천,질병,0,1,1
M16,2021,광주,질병,0,1,1
M16,2021,대구,질병,1,3,4
M16,2021,대전,질병,2,0,2
M16,2021,부산,질병,16,2,18
M16,2021,서울,질병,3,2,5
M16,2021,인천,질병,0,2,2
M16,2022,광주,질병,3,0,3
M16,2022,대전,질병,1,3,4
M16,2022,부산,질병,10,2,12
M16,2022,서울,질병,8,10,18
M16,2023,대구,질병,3,0,3
M16,2023,대전,질병,1,0,1
M16,2023,부산,질병,9,0,9
M16,2023,서울,질병,5,9,14
M16,2023,인천,질병,0,1,1
M17,2019,광주,질병,90,99,189
M17,2019,대구,질병,49,127,176
M17,2019,대전,질병,100,74,174
M17,2019,부산,질병,128,88,216
M17,2019,서울,질병,188,448,636
M17,2019,인천,질병,8,29,37
M17,2020,광주,질병,79,85,164
M17,2020,대구,질병,75,115,190
M17,2020,대전,질병,81,69,150
M17,2020,서울,질병,176,420,596
M17,2020,인천,질병,6,26,32
M17,2021,광주,질병,70,79,149
M17,2021,대구,질병,83,88,171
M17,2021,대전,질병,103,85,188
M17,2021,부산,질병,103,74,177
M17,2021,서울,질병,146,384,530
M17,2021,인천,질병,15,49,64
M17,2022,광주,질병,58,64,122
M17,2022,대구,질병,50,89,139
M17,2022,대전,질병,81,84,165
M17,2022,부산,질병,84,62,146
M17,2022,서울,질병,108,366,474
M17,2022,인천,질병,2,8,10
M17,2023,광주,질병,17,42,59
M17,2023,대구,질병,53,118,171
M17,2023,대전,질병,125,112,237
M17,2023,부산,질병,53,68,121
M17,2023,서울,질병,172,366,538
M17,2023,인천,질병,12,47,59
M18,2019,서울,질병,0,2,2
M18,2020,대구,질병,0,1,1
M18,2020,서울,질병,1,0,1
M18,2021,대전,질병,1,0,1
M18,2022,부산,질병,1,0,1
M18,2022,서울,질병,0,1,1
M18,2023,서울,질병,3,1,4
M19,2019,광주,질병,12,9,21
M19,2019,대구,질병,14,9,23
M19,2019,대전,질병,10,6,16
M19,2019,부산,질병,15,1,16
M19,2019,서울,질병,42,35,77
M19,2019,인천,질병,12,35,47
M19,2020,광주,질병,11,11,22
M19,2020,대구,질병,15,7,22
M19,2020,대전,질병,7,2,9
M19,2020,서울,질병,29,35,64
M19,2020,인천,질병,16,48,64
M19,2021,광주,질병,10,5,15
M19,2021,대구,질병,15,5,20
M19,2021,대전,질병,4,5,9
M19,2021,부산,질병,9,5,14
M19,2021,서울,질병,19,27,46
M19,2021,인천,질병,8,38,46
M19,2022,광주,질병,9,3,12
M19,2022,대구,질병,20,3,23
M19,2022,대전,질병,4,1,5
M19,2022,부산,질병,10,1,11
M19,2022,서울,질병,41,25,66
M19,2022,인천,질병,3,7,10
M19,2023,광주,질병,15,7,22
M19,2023,대구,질병,15,5,20
M19,2023,대전,질병,5,3,8
M19,2023,부산,질병,9,0,9
M19,2023,서울,질병,42,46,88
M19,2023,인천,질병,1,5,6
M20,2019,광주,질병,9,10,19
M20,2019,대구,질병,10,11,21
M20,2019,대전,질병,2,6,8
M20,2019,부산,질병,4,2,6
M20,2019,서울,질병,17,30,47
M20,2019,인천,질병,0,2,2
M20,2020,광주,질병,16,13,29
M20,2020,대구,질병,11,13,24
M20,2020,대전,질병,2,1,3
M20,2020,서울,질병,21,35,56
M20,2021,광주,질병,6,0,6
M20,2021,대구,질병,20,3,23
M20,2021,대전,질병,4,2,6
M20,2021,부산,질병,14,6,20
M20,2021,서울,질병,18,23,41
M20,2021,인천,질병,0,3,3
M20,2022,광주,질병,2,0,2
M20,2022,대구,질병,20,8,28
M20,2022,대전,질병,8,2,10
M20,2022,부산,질병,14,3,17
M20,2022,서울,질병,16,32,48
M20,2022,인천,질병,1,0,1
M20,2023,광주,질병,1,1,2
M20,2023,대구,질병,10,6,16
M20,2023,대전,질병,1,1,2
M20,2023,부산,질병,4,0,4
M20,2023,서울,질병,11,39,50
M20,2023,인천,질병,3,1,4
M21,2019,광주,질병,1,0,1
M21,2019,부산,질병,2,0,2
M21,2019,서울,질병,11,8,19
M21,2020,광주,질병,1,0,1
M21,2020,서울,질병,3,5,8
M21,2021,광주,질병,0,1,1
M21,2021,부산,질병,3,0,3
M21,2021,서울,질병,5,4,9
M21,2022,광주,질병,0,3,3
M21,2022,대구,질병,1,0,1
M21,2022,서울,질병,7,9,16
M21,2023,광주,질병,0,2,2
M21,2023,대구,질병,2,0,2
M21,2023,대전,질병,1,0,1
M21,2023,서울,질병,6,7,13
M22,2019,부산,질병,4,0,4
M22,2019,서울,질병,1,0,1
M22,2020,서울,질병,0,3,3
M22,2021,부산,질병,3,0,3
M22,2021,서울,질병,1,0,1
M22,2022,대구,질병,1,0,1
M22,2022,부산,질병,3,0,3
M22,2023,부산,질병,2,0,2
M22,2023,서울,질병,1,0,1
M23,2019,광주,질병,7,8,15
M23,2019,대구,질병,7,8,15
M23,2019,대전,질병,19,12,31
M23,2019,부산,질병,8,2,10
M23,2019,서울,질병,34,51,85
M23,2020,광주,질병,4,5,9
M23,2020,대구,질병,12,3,15
M23,2020,대전,질병,13,11,24
M23,2020,서울,질병,38,51,89
M23,2021,광주,질병,13,10,23
M23,2021,대구,질병,11,11,22
M23,2021,대전,질병,20,3,23
M23,2021,부산,질병,7,0,7
M23,2021,서울,질병,33,39,72
M23,2021,인천,질병,0,1,1
M23,2022,광주,질병,4,4,8
M23,2022,대구,질병,14,5,19
M23,2022,대전,질병,12,6,18
M23,2022,부산,질병,6,7,13
M23,2022,서울,질병,24,40,64
M23,2022,인천,질병,1,1,2
M23,2023,광주,질병,3,3,6
M23,2023,대구,질병,16,7,23
M23,2023,대전,질병,5,7,12
M23,2023,부산,질병,13,11,24
M23,2023,서울,질병,32,39,71
M23,2023,인천,질병,2,7,9
M24,2019,광주,질병,1,0,1
M24,2019,대구,질병,1,4,5
M24,2019,대전,질병,4,5,9
M24,2019,부산,질병,8,0,8
M24,2019,서울,질병,4,5,9
M24,2020,대구,질병,3,1,4
M24,2020,대전,질병,2,0,2
M24,2020,서울,질병,13,7,20
M24,2020,인천,질병,4,0,4
M24,2021,대구,질병,1,1,2
M24,2021,대전,질병,6,0,6
M24,2021,부산,질병,5,0,5
M24,2021,서울,질병,8,11,19
M24,2021,인천,질병,1,0,1
M24,2022,대구,질병,1,0,1
M24,2022,대전,질병,1,2,3
M24,2022,부산,질병,1,0,1
M24,2022,서울,질병,21,16,37
M24,2022,인천,질병,0,1,1
M24,2023,대전,질병,5,4,9
M24,2023,부산,질병,3,0,3
M24,2023,서울,질병,8,3,11
M25,2019,광주,질병,0,1,1
M25,2019,대구,질병,6,2,8
M25,2019,대전,질병,7,0,7
M25,2019,부산,질병,5,0,5
M25,2019,서울,질병,21,14,35
M25,2020,광주,질병,1,2,3
M25,2020,대구,질병,9,2,11
M25,2020,대전,질병,4,0,4
M25,2020,서울,질병,20,18,38
M25,2020,인천,질병,0,1,1
M25,2021,광주,질병,2,0,2
M25,2021,대구,질병,10,0,10
M25,2021,대전,질병,6,1,7
M25,2021,부산,질병,4,1,5
M25,2021,서울,질병,8,7,15
M25,2021,인천,질병,3,0,3
M25,2022,광주,질병,2,0,2
M25,2022,대구,질병,12,0,12
M25,2022,대전,질병,6,3,9
M25,2022,부산,질병,1,0,1
M25,2022,서울,질병,14,9,23
M25,2022,인천,질병,0,1,1
M25,2023,광주,질병,2,3,5
M25,2023,대구,질병,13,2,15
M25,2023,대전,질병,14,8,22
M25,2023,부산,질병,2,0,2
M25,2023,서울,질병,20,6,26
M25,2023,인천,질병,1,0,1
M30,2019,광주,질병,0,6,6
M30,2019,대구,질병,0,1,1
M30,2020,광주,질병,0,1,1
M30,2020,서울,질병,4,0,4
M30,2021,대구,질병,1,0,1
M30,2021,부산,질병,2,0,2
M30,2022,대구,질병,1,0,1
M31,2019,서울,질병,9,3,12
M31,2020,광주,질병,1,0,1
M31,2020,서울,질병,2,4,6
M31,2021,서울,질병,4,2,6
M31,2022,서울,질병,4,1,5
M31,2023,서울,질병,2,10,12
M32,2020,대전,질병,0,1,1
M32,2021,서울,질병,0,2,2
M32,2022,서울,질병,1,1,2
M32,2023,서울,질병,2,1,3
M33,2020,서울,질병,0,1,1
M33,2021,서울,질병,0,1,1
M33,2022,서울,질병,4,1,5
M33,2023,서울,질병,1,0,1
M34,2021,부산,질병,1,0,1
M34,2022,서울,질병,1,1,2
M34,2023,서울,질병,1,1,2
M35,2019,부산,질병,2,0,2
M35,2019,서울,질병,2,5,7
M35,2020,대구,질병,2,1,3
M35,2020,서울,질병,8,3,11
M35,2021,광주,질병,0,1,1
M35,2021,대전,질병,1,0,1
M35,2021,부산,질병,1,0,1
M35,2021,서울,질병,2,3,5
M35,2022,광주,질병,0,1,1
M35,2022,서울,질병,4,1,5
M35,2023,대전,질병,1,0,1
M35,2023,부산,질병,3,0,3
M35,2023,서울,질병,3,7,10
M40,2019,광주,질병,0,2,2
M40,2019,대전,질병,5,1,6
M40,2019,서울,질병,1,1,2
M40,2020,광주,질병,0,1,1
M40,2020,대전,질병,2,1,3
M40,2020,서울,질병,1,3,4
M40,2021,서울,질병,2,2,4
M40,2022,대구,질병,1,0,1
M40,2022,대전,질병,3,0,3
M40,2022,서울,질병,2,2,4
M40,2022,인천,질병,1,0,1
M40,2023,대구,질병,0,1,1
M40,2023,대전,질병,2,1,3
M40,2023,서울,질병,2,2,4
M40,2023,인천,질병,1,0,1
M41,2019,대구,질병,0,1,1
M41,2019,대전,질병,0,1,1
M41,2019,서울,질병,1,8,9
M41,2020,광주,질병,2,0,2
M41,2020,대전,질병,6,2,8
M41,2020,서울,질병,0,3,3
M41,2021,광주,질병,0,1,1
M41,2021,대전,질병,1,0,1
M41,2021,서울,질병,1,3,4
M41,2022,부산,질병,0,1,1
M41,2022,서울,질병,1,2,3
M41,2023,대전,질병,1,0,1
M41,2023,부산,질병,0,1,1
M41,2023,서울,질병,4,2,6
M41,2023,인천,질병,0,1,1
M43,2019,광주,질병,4,7,11
M43,2019,대구,질병,16,8,24
M43,2019,대전,질병,100,34,134
M43,2019,부산,질병,52,21,73
M43,2019,서울,질병,26,54,80
M43,2020,광주,질병,13,3,16
M43,2020,대구,질병,16,1,17
M43,2020,대전,질병,108,15,123
M43,2020,서울,질병,41,60,101
M43,2020,인천,질병,0,1,1
M43,2021,광주,질병,5,4,9
M43,2021,대구,질병,21,10,31
M43,2021,대전,질병,78,16,94
M43,2021,부산,질병,79,28,107
M43,2021,서울,질병,35,38,73
M43,2021,인천,질병,0,2,2
M43,2022,광주,질병,0,2,2
M43,2022,대구,질병,12,16,28
M43,2022,대전,질병,82,24,106
M43,2022,부산,질병,84,24,108
M43,2022,서울,질병,33,71,104
M43,2022,인천,질병,0,3,3
M43,2023,광주,질병,1,0,1
M43,2023,대구,질병,26,14,40
M43,2023,대전,질병,77,20,97
M43,2023,부산,질병,84,25,109
M43,2023,서울,질병,87,90,177
M43,2023,인천,질병,2,2,4
M45,2019,대구,질병,1,0,1
M45,2019,부산,질병,3,0,3
M45,2019,서울,질병,2,1,3
M45,2019,인천,질병,1,0,1
M45,2020,광주,질병,0,1,1
M45,2020,대구,질병,0,1,1
M45,2020,대전,질병,1,0,1
M45,2020,서울,질병,2,1,3
M45,2021,광주,질병,1,0,1
M45,2021,대전,질병,1,0,1
M45,2021,서울,질병,1,0,1
M45,2022,광주,질병,1,0,1
M45,2022,대전,질병,5,0,5
M45,2022,부산,질병,2,0,2
M45,2023,대전,질병,2,0,2
M45,2023,부산,질병,2,0,2
M46,2019,광주,질병,4,3,7
M46,2019,대구,질병,6,2,8
M46,2019,대전,질병,3,1,4
M46,2019,부산,질병,8,0,8
M46,2019,서울,질병,15,9,24
M46,2020,광주,질병,3,5,8
M46,2020,대구,질병,5,2,7
M46,2020,대전,질병,5,0,5
M46,2020,서울,질병,8,12,20
M46,2020,인천,질병,0,2,2
M46,2021,광주,질병,0,1,1
M46,2021,대구,질병,4,3,7
M46,2021,대전,질병,4,7,11
M46,2021,서울,질병,16,13,29
M46,2021,인천,질병,1,0,1
M46,2022,광주,질병,5,1,6
M46,2022,대구,질병,8,0,8
M46,2022,대전,질병,4,5,9
M46,2022,부산,질병,4,1,5
M46,2022,서울,질병,14,12,26
M46,2023,광주,질병,3,0,3
M46,2023,대구,질병,9,4,13
M46,2023,대전,질병,6,1,7
M46,2023,부산,질병,5,2,7
M46,2023,서울,질병,17,16,33
M46,2023,인천,질병,0,1,1
M47,2019,광주,질병,18,14,32
M47,2019,대구,질병,3,0,3
M47,2019,대전,질병,1,1,2
M47,2019,부산,질병,118,37,155
M47,2019,서울,질병,31,14,45
M47,2019,인천,질병,0,1,1
M47,2020,광주,질병,11,23,34
M47,2020,대구,질병,2,0,2
M47,2020,대전,질병,3,0,3
M47,2020,서울,질병,18,9,27
M47,2020,인천,질병,1,6,7
M47,2021,광주,질병,17,9,26
M47,2021,대구,질병,2,1,3
M47,2021,대전,질병,7,0,7
M47,2021,부산,질병,128,26,154
M47,2021,서울,질병,13,5,18
M47,2021,인천,질병,5,1,6
M47,2022,광주,질병,4,3,7
M47,2022,대구,질병,6,0,6
M47,2022,대전,질병,9,1,10
M47,2022,부산,질병,105,37,142
M47,2022,서울,질병,22,20,42
M47,2023,광주,질병,8,4,12
M47,2023,대구,질병,4,2,6
M47,2023,대전,질병,8,3,11
M47,2023,부산,질병,104,27,131
M47,2023,서울,질병,40,34,74
M47,2023,인천,질병,0,1,1
M48,2019,광주,질병,229,108,337
M48,2019,대구,질병,241,106,347
M48,2019,대전,질병,842,111,953
M48,2019,부산,질병,515,80,595
M48,2019,서울,질병,574,465,1039
M48,2019,인천,질병,59,102,161
M48,2020,광주,질병,266,109,375
M48,2020,대구,질병,236,72,308
M48,2020,대전,질병,903,70,973
M48,2020,서울,질병,477,392,869
M48,2020,인천,질병,45,74,119
M48,2021,광주,질병,341,250,591
M48,2021,대구,질병,249,82,331
M48,2021,대전,질병,801,97,898
M48,2021,부산,질병,543,64,607
M48,2021,서울,질병,314,285,599
M48,2021,인천,질병,69,69,138
M48,2022,광주,질병,259,180,439
M48,2022,대구,질병,200,87,287
M48,2022,대전,질병,711,117,828
M48,2022,부산,질병,487,67,554
M48,2022,서울,질병,319,329,648
M48,2022,인천,질병,33,29,62
M48,2023,광주,질병,282,67,349
M48,2023,대구,질병,159,47,206
M48,2023,대전,질병,746,111,857
M48,2023,부산,질병,546,62,608
M48,2023,서울,질병,475,420,895
M48,2023,인천,질병,186,123,309
M49,2019,서울,질병,14,5,19
M49,2020,광주,질병,0,1,1
M49,2020,대전,질병,0,2,2
M49,2020,서울,질병,3,6,9
M49,2020,인천,질병,0,1,1
M49,2021,광주,질병,1,1,2
M49,2021,대구,질병,0,1,1
M49,2021,대전,질병,0,4,4
M49,2021,서울,질병,6,8,14
M49,2022,광주,질병,1,1,2
M49,2022,대구,질병,1,0,1
M49,2022,서울,질병,13,8,21
M49,2023,대구,질병,1,1,2
M49,2023,서울,질병,8,6,14
M50,2019,광주,질병,23,11,34
M50,2019,대구,질병,21,2,23
M50,2019,대전,질병,32,4,36
M50,2019,부산,질병,142,9,151
M50,2019,서울,질병,67,19,86
M50,2019,인천,질병,1,3,4
M50,2020,광주,질병,18,7,25
M50,2020,대구,질병,9,2,11
M50,2020,대전,질병,28,2,30
M50,2020,서울,질병,48,28,76
M50,2020,인천,질병,4,1,5
M50,2021,광주,질병,18,3,21
M50,2021,대구,질병,33,6,39
M50,2021,대전,질병,30,1,31
M50,2021,부산,질병,151,17,168
M50,2021,서울,질병,27,12,39
M50,2021,인천,질병,2,8,10
M50,2022,광주,질병,3,0,3
M50,2022,대구,질병,30,6,36
M50,2022,대전,질병,31,3,34
M50,2022,부산,질병,123,12,135
M50,2022,서울,질병,23,17,40
M50,2022,인천,질병,1,4,5
M50,2023,광주,질병,7,3,10
M50,2023,대구,질병,30,8,38
M50,2023,대전,질병,62,7,69
M50,2023,부산,질병,112,9,121
M50,2023,서울,질병,55,26,81
M50,2023,인천,질병,3,4,7
M51,2019,광주,질병,71,33,104
M51,2019,대구,질병,119,41,160
M51,2019,대전,질병,165,42,207
M51,2019,부산,질병,292,70,362
M51,2019,서울,질병,182,113,295
M51,2019,인천,질병,6,7,13
M51,2020,광주,질병,58,29,87
M51,2020,대구,질병,128,31,159
M51,2020,대전,질병,161,33,194
M51,2020,서울,질병,133,109,242
M51,2020,인천,질병,5,4,9
M51,2021,광주,질병,65,29,94
M51,2021,대구,질병,199,34,233
M51,2021,대전,질병,136,30,166
M51,2021,부산,질병,291,47,338
M51,2021,서울,질병,104,69,173
M51,2021,인천,질병,2,2,4
M51,2022,광주,질병,30,10,40
M51,2022,대구,질병,246,50,296
M51,2022,대전,질병,150,31,181
M51,2022,부산,질병,288,54,342
M51,2022,서울,질병,105,87,192
M51,2022,인천,질병,3,4,7
M51,2023,광주,질병,88,29,117
M51,2023,대구,질병,310,51,361
M51,2023,대전,질병,209,38,247
M51,2023,부산,질병,268,48,316
M51,2023,서울,질병,211,162,373
M51,2023,인천,질병,14,12,26
M53,2019,대전,질병,1,0,1
M53,2019,부산,질병,18,8,26
M53,2019,서울,질병,15,14,29
M53,2020,서울,질병,15,14,29
M53,2020,인천,질병,5,0,5
M53,2021,대전,질병,1,1,2
M53,2021,부산,질병,31,11,42
M53,2021,서울,질병,8,7,15
M53,2021,인천,질병,0,1,1
M53,2022,부산,질병,32,15,47
M53,2022,서울,질병,7,5,12
M53,2023,부산,질병,33,14,47
M53,2023,서울,질병,9,16,25
M54,2019,광주,질병,15,14,29
M54,2019,대구,질병,7,2,9
M54,2019,대전,질병,146,26,172
M54,2019,부산,질병,29,3,32
M54,2019,서울,질병,78,25,103
M54,2019,인천,질병,1,3,4
M54,2020,광주,질병,15,13,28
M54,2020,대구,질병,4,0,4
M54,2020,대전,질병,84,16,100
M54,2020,서울,질병,35,29,64
M54,2020,인천,질병,1,5,6
M54,2021,광주,질병,11,15,26
M54,2021,대구,질병,4,2,6
M54,2021,대전,질병,105,29,134
M54,2021,부산,질병,27,5,32
M54,2021,서울,질병,14,6,20
M54,2021,인천,질병,9,6,15
M54,2022,광주,질병,10,9,19
M54,2022,대구,질병,13,4,17
M54,2022,대전,질병,76,9,85
M54,2022,부산,질병,29,3,32
M54,2022,서울,질병,23,16,39
M54,2022,인천,질병,4,7,11
M54,2023,광주,질병,21,4,25
M54,2023,대구,질병,6,5,11
M54,2023,대전,질병,128,39,167
M54,2023,부산,질병,49,20,69
M54,2023,서울,질병,25,22,47
M54,2023,인천,질병,5,9,14
M60,2019,광주,질병,1,0,1
M60,2019,대전,질병,0,1,1
M60,2019,서울,질병,3,6,9
M60,2020,광주,질병,1,0,1
M60,2020,대전,질병,1,1,2
M60,2020,서울,질병,11,6,17
M60,2021,광주,질병,1,0,1
M60,2021,대구,질병,1,0,1
M60,2021,대전,질병,4,0,4
M60,2021,서울,질병,5,2,7
M60,2022,광주,질병,1,2,3
M60,2022,대구,질병,1,0,1
M60,2022,대전,질병,1,0,1
M60,2022,서울,질병,3,10,13
M60,2023,광주,질병,1,0,1
M60,2023,대전,질병,1,0,1
M60,2023,부산,질병,1,0,1
M60,2023,서울,질병,9,2,11
M61,2019,부산,질병,0,1,1
M61,2019,서울,질병,0,1,1
M61,2020,서울,질병,2,1,3
M61,2022,서울,질병,1,0,1
M61,2023,대구,질병,0,1,1
M61,2023,대전,질병,1,0,1
M61,2023,서울,질병,0,1,1
M62,2019,광주,질병,4,1,5
M62,2019,대구,질병,3,0,3
M62,2019,대전,질병,2,2,4
M62,2019,부산,질병,4,2,6
M62,2019,서울,질병,18,12,30
M62,2020,광주,질병,4,4,8
M62,2020,대구,질병,1,2,3
M62,2020,대전,질병,3,4,7
M62,2020,서울,질병,12,13,25
M62,2020,인천,질병,1,0,1
M62,2021,광주,질병,2,0,2
M62,2021,대구,질병,1,0,1
M62,2021,대전,질병,1,0,1
M62,2021,부산,질병,3,0,3
M62,2021,서울,질병,8,10,18
M62,2022,광주,질병,0,2,2
M62,2022,대구,질병,1,0,1
M62,2022,대전,질병,1,2,3
M62,2022,서울,질병,7,5,12
M62,2023,광주,질병,1,3,4
M62,2023,대구,질병,2,0,2
M62,2023,대전,질병,5,5,10
M62,2023,서울,질병,12,8,20
M62,2023,인천,질병,0,1,1
M63,2019,서울,질병,1,0,1
M63,2023,부산,질병,1,0,1
M65,2019,광주,질병,5,4,9
M65,2019,대구,질병,7,3,10
M65,2019,대전,질병,2,1,3
M65,2019,부산,질병,1,1,2
M65,2019,서울,질병,20,17,37
M65,2019,인천,질병,0,1,1
M65,2020,광주,질병,3,2,5
M65,2020,대구,질병,7,3,10
M65,2020,대전,질병,7,3,10
M65,2020,서울,질병,22,31,53
M65,2020,인천,질병,0,1,1
M65,2021,광주,질병,6,4,10
M65,2021,대구,질병,10,7,17
M65,2021,대전,질병,10,3,13
M65,2021,부산,질병,5,0,5
M65,2021,서울,질병,6,10,16
M65,2021,인천,질병,0,2,2
M65,2022,광주,질병,5,0,5
M65,2022,대구,질병,6,0,6
M65,2022,대전,질병,15,0,15
M65,2022,부산,질병,0,1,1
M65,2022,서울,질병,9,11,20
M65,2022,인천,질병,0,1,1
M65,2023,광주,질병,11,7,18
M65,2023,대구,질병,5,3,8
M65,2023,대전,질병,5,1,6
M65,2023,부산,질병,3,2,5
M65,2023,서울,질병,13,15,28
M65,2023,인천,질병,3,5,8
M66,2020,서울,질병,0,1,1
M66,2023,서울,질병,1,1,2
M67,2019,광주,질병,2,9,11
M67,2019,대구,질병,4,0,4
M67,2019,대전,질병,2,3,5
M67,2019,부산,질병,1,1,2
M67,2019,서울,질병,7,10,17
M67,2019,인천,질병,0,2,2
M67,2020,광주,질병,1,4,5
M67,2020,대구,질병,5,1,6
M67,2020,대전,질병,7,6,13
M67,2020,서울,질병,7,9,16
M67,2020,인천,질병,3,1,4
M67,2021,광주,질병,1,2,3
M67,2021,대구,질병,4,3,7
M67,2021,대전,질병,5,3,8
M67,2021,부산,질병,5,0,5
M67,2021,서울,질병,4,7,11
M67,2021,인천,질병,0,1,1
M67,2022,광주,질병,2,1,3
M67,2022,대구,질병,2,0,2
M67,2022,대전,질병,4,1,5
M67,2022,부산,질병,2,2,4
M67,2022,서울,질병,2,6,8
M67,2023,광주,질병,1,0,1
M67,2023,대구,질병,1,2,3
M67,2023,대전,질병,0,2,2
M67,2023,부산,질병,1,1,2
M67,2023,서울,질병,7,13,20
M67,2023,인천,질병,1,0,1
M70,2019,광주,질병,2,1,3
M70,2019,대구,질병,3,0,3
M70,2019,대전,질병,3,2,5
M70,2019,부산,질병,2,0,2
M70,2019,서울,질병,7,3,10
M70,2019,인천,질병,2,0,2
M70,2020,광주,질병,2,0,2
M70,2020,대구,질병,4,1,5
M70,2020,대전,질병,4,2,6
M70,2020,서울,질병,7,3,10
M70,2021,광주,질병,4,0,4
M70,2021,대구,질병,6,0,6
M70,2021,대전,질병,3,0,3
M70,2021,부산,질병,0,1,1
M70,2021,서울,질병,5,6,11
M70,2022,광주,질병,3,1,4
M70,2022,대구,질병,3,0,3
M70,2022,대전,질병,0,1,1
M70,2022,부산,질병,2,0,2
M70,2022,서울,질병,4,5,9
M70,2023,광주,질병,3,1,4
M70,2023,대구,질병,2,2,4
M70,2023,부산,질병,2,0,2
M70,2023,서울,질병,8,7,15
M70,2023,인천,질병,0,1,1
M71,2019,광주,질병,6,1,7
M71,2019,대구,질병,5,3,8
M71,2019,대전,질병,5,6,11
M71,2019,부산,질병,3,3,6
M71,2019,서울,질병,11,11,22
M71,2019,인천,질병,2,2,4
M71,2020,광주,질병,8,1,9
M71,2020,대구,질병,1,4,5
M71,2020,대전,질병,7,1,8
M71,2020,서울,질병,6,8,14
M71,2021,광주,질병,5,4,9
M71,2021,대구,질병,3,2,5
M71,2021,대전,질병,3,1,4
M71,2021,부산,질병,4,1,5
M71,2021,서울,질병,8,7,15
M71,2022,광주,질병,2,0,2
M71,2022,대구,질병,4,0,4
M71,2022,대전,질병,5,0,5
M71,2022,부산,질병,0,2,2
M71,2022,서울,질병,8,14,22
M71,2023,광주,질병,6,7,13
M71,2023,대구,질병,4,2,6
M71,2023,대전,질병,2,1,3
M71,2023,부산,질병,3,3,6
M71,2023,서울,질병,15,9,24
M71,2023,인천,질병,1,1,2
M72,2019,광주,질병,6,1,7
M72,2019,대구,질병,5,1,6
M72,2019,대전,질병,3,1,4
M72,2019,부산,질병,2,0,2
M72,2019,서울,질병,21,17,38
M72,2019,인천,질병,1,2,3
M72,2020,광주,질병,3,1,4
M72,2020,대구,질병,4,1,5
M72,2020,대전,질병,1,0,1
M72,2020,서울,질병,19,21,40
M72,2020,인천,질병,1,2,3
M72,2021,광주,질병,1,0,1
M72,2021,대구,질병,3,5,8
M72,2021,대전,질병,0,1,1
M72,2021,부산,질병,0,2,2
M72,2021,서울,질병,8,2,10
M72,2021,인천,질병,0,1,1
M72,2022,광주,질병,1,1,2
M72,2022,대구,질병,8,0,8
M72,2022,대전,질병,5,2,7
M72,2022,부산,질병,2,1,3
M72,2022,서울,질병,10,3,13
M72,2022,인천,질병,1,1,2
M72,2023,광주,질병,1,1,2
M72,2023,대구,질병,2,1,3
M72,2023,대전,질병,4,0,4
M72,2023,부산,질병,2,2,4
M72,2023,서울,질병,12,6,18
M72,2023,인천,질병,1,0,1
M75,2019,광주,질병,62,44,106
M75,2019,대구,질병,68,48,116
M75,2019,대전,질병,106,70,176
M75,2019,부산,질병,43,18,61
M75,2019,서울,질병,192,206,398
M75,2019,인천,질병,9,18,27
M75,2020,광주,질병,76,44,120
M75,2020,대구,질병,75,33,108
M75,2020,대전,질병,133,62,195
M75,2020,서울,질병,170,207,377
M75,2020,인천,질병,9,26,35
M75,2021,광주,질병,70,43,113
M75,2021,대구,질병,59,47,106
M75,2021,대전,질병,169,61,230
M75,2021,부산,질병,62,39,101
M75,2021,서울,질병,158,151,309
M75,2021,인천,질병,9,37,46
M75,2022,광주,질병,30,27,57
M75,2022,대구,질병,54,45,99
M75,2022,대전,질병,145,62,207
M75,2022,부산,질병,43,21,64
M75,2022,서울,질병,144,164,308
M75,2022,인천,질병,1,5,6
M75,2023,광주,질병,24,21,45
M75,2023,대구,질병,48,47,95
M75,2023,대전,질병,217,71,288
M75,2023,부산,질병,49,35,84
M75,2023,서울,질병,163,189,352
M75,2023,인천,질병,28,46,74
M76,2019,광주,질병,2,0,2
M76,2019,대구,질병,2,0,2
M76,2019,서울,질병,6,2,8
M76,2020,광주,질병,1,2,3
M76,2020,대구,질병,8,1,9
M76,2020,대전,질병,1,0,1
M76,2020,서울,질병,5,1,6
M76,2021,광주,질병,2,4,6
M76,2021,대구,질병,4,0,4
M76,2021,대전,질병,2,1,3
M76,2021,부산,질병,0,1,1
M76,2021,서울,질병,2,2,4
M76,2022,대구,질병,2,0,2
M76,2022,대전,질병,1,1,2
M76,2022,서울,질병,3,3,6
M76,2023,광주,질병,2,2,4
M76,2023,대구,질병,3,0,3
M76,2023,대전,질병,1,0,1
M76,2023,서울,질병,2,1,3
M77,2019,광주,질병,1,0,1
M77,2019,대전,질병,3,0,3
M77,2019,부산,질병,4,3,7
M77,2019,서울,질병,6,8,14
M77,2019,인천,질병,1,3,4
M77,2020,광주,질병,2,0,2
M77,2020,대구,질병,0,1,1
M77,2020,대전,질병,7,1,8
M77,2020,서울,질병,2,7,9
M77,2020,인천,질병,0,4,4
M77,2021,대구,질병,3,0,3
M77,2021,대전,질병,7,0,7
M77,2021,부산,질병,6,0,6
M77,2021,서울,질병,4,1,5
M77,2021,인천,질병,0,3,3
M77,2022,대전,질병,3,3,6
M77,2022,부산,질병,5,0,5
M77,2022,서울,질병,1,1,2
M77,2023,대구,질병,2,0,2
M77,2023,대전,질병,8,3,11
M77,2023,부산,질병,3,0,3
M77,2023,서울,질병,6,5,11
M77,2023,인천,질병,3,1,4
M79,2019,광주,질병,7,2,9
M79,2019,대구,질병,22,6,28
M79,2019,대전,질병,18,5,23
M79,2019,부산,질병,28,3,31
M79,2019,서울,질병,52,15,67
M79,2019,인천,질병,0,4,4
M79,2020,광주,질병,3,0,3
M79,2020,대구,질병,16,2,18
M79,2020,대전,질병,16,6,22
M79,2020,서울,질병,33,23,56
M79,2020,인천,질병,0,1,1
M79,2021,광주,질병,3,1,4
M79,2021,대구,질병,12,4,16
M79,2021,대전,질병,18,4,22
M79,2021,부산,질병,19,5,24
M79,2021,서울,질병,9,16,25
M79,2021,인천,질병,1,0,1
M79,2022,광주,질병,7,3,10
M79,2022,대구,질병,8,1,9
M79,2022,대전,질병,7,2,9
M79,2022,부산,질병,20,8,28
M79,2022,서울,질병,26,14,40
M79,2023,광주,질병,2,0,2
M79,2023,대구,질병,9,3,12
M79,2023,대전,질병,10,1,11
M79,2023,부산,질병,15,1,16
M79,2023,서울,질병,20,19,39
M79,2023,인천,질병,2,0,2
M80,2019,광주,질병,1,1,2
M80,2019,대구,질병,0,3,3
M80,2019,대전,질병,3,7,10
M80,2019,부산,질병,3,0,3
M80,2019,서울,질병,7,9,16
M80,2020,광주,질병,0,3,3
M80,2020,대구,질병,2,2,4
M80,2020,대전,질병,2,0,2
M80,2020,서울,질병,7,9,16
M80,2021,광주,질병,0,2,2
M80,2021,대구,질병,1,0,1
M80,2021,대전,질병,3,4,7
M80,2021,부산,질병,1,0,1
M80,2021,서울,질병,0,5,5
M80,2021,인천,질병,0,1,1
M80,2022,대구,질병,5,1,6
M80,2022,대전,질병,3,1,4
M80,2022,부산,질병,1,0,1
M80,2022,서울,질병,5,3,8
M80,2022,인천,질병,1,5,6
M80,2023,대구,질병,0,1,1
M80,2023,대전,질병,1,0,1
M80,2023,부산,질병,1,0,1
M80,2023,서울,질병,8,5,13
M80,2023,인천,질병,0,2,2
M81,2019,광주,질병,1,2,3
M81,2019,대구,질병,24,13,37
M81,2019,대전,질병,33,22,55
M81,2019,부산,질병,22,10,32
M81,2019,서울,질병,73,119,192
M81,2019,인천,질병,1,0,1
M81,2020,대구,질병,24,11,35
M81,2020,대전,질병,19,12,31
M81,2020,서울,질병,68,129,197
M81,2020,인천,질병,2,1,3
M81,2021,광주,질병,0,2,2
M81,2021,대구,질병,7,12,19
M81,2021,대전,질병,15,4,19
M81,2021,부산,질병,28,8,36
M81,2021,서울,질병,24,87,111
M81,2022,광주,질병,1,1,2
M81,2022,대구,질병,2,1,3
M81,2022,대전,질병,14,1,15
M81,2022,부산,질병,26,11,37
M81,2022,서울,질병,34,78,112
M81,2023,광주,질병,1,0,1
M81,2023,대구,질병,2,4,6
M81,2023,대전,질병,13,4,17
M81,2023,부산,질병,25,9,34
M81,2023,서울,질병,122,294,416
M82,2019,대전,질병,9,4,13
M82,2019,부산,질병,0,1,1
M82,2019,인천,질병,0,1,1
M82,2020,대전,질병,3,2,5
M82,2021,대전,질병,13,3,16
M82,2021,부산,질병,1,0,1
M82,2021,서울,질병,1,0,1
M82,2022,대전,질병,10,0,10
M82,2022,부산,질병,5,0,5
M82,2023,대전,질병,29,3,32
M82,2023,부산,질병,3,0,3
M83,2019,대전,질병,2,0,2
M83,2020,대전,질병,2,0,2
M83,2020,서울,질병,1,0,1
M83,2021,대전,질병,5,0,5
M83,2022,대전,질병,7,1,8
M83,2023,대전,질병,6,2,8
M84,2019,광주,질병,0,2,2
M84,2019,대구,질병,4,3,7
M84,2019,대전,질병,8,2,10
M84,2019,부산,질병,1,0,1
M84,2019,서울,질병,18,3,21
M84,2019,인천,질병,0,1,1
M84,2020,대구,질병,5,0,5
M84,2020,대전,질병,6,14,20
M84,2020,서울,질병,10,16,26
M84,2020,인천,질병,0,1,1
M84,2021,광주,질병,6,1,7
M84,2021,대구,질병,2,4,6
M84,2021,대전,질병,10,13,23
M84,2021,서울,질병,9,19,28
M84,2022,광주,질병,0,1,1
M84,2022,대구,질병,2,0,2
M84,2022,대전,질병,3,3,6
M84,2022,부산,질병,0,1,1
M84,2022,서울,질병,4,7,11
M84,2022,인천,질병,1,0,1
M84,2023,대구,질병,1,1,2
M84,2023,대전,질병,1,0,1
M84,2023,서울,질병,6,7,13
M85,2019,대구,질병,2,0,2
M85,2019,부산,질병,1,1,2
M85,2019,서울,질병,1,4,5
M85,2020,서울,질병,0,1,1
M85,2021,광주,질병,0,1,1
M85,2021,대구,질병,0,1,1
M85,2021,서울,질병,7,7,14
M85,2022,대전,질병,0,2,2
M85,2022,서울,질병,4,13,17
M85,2023,광주,질병,3,0,3
M85,2023,대전,질병,1,0,1
M85,2023,서울,질병,3,3,6
M86,2019,광주,질병,5,2,7
M86,2019,대구,질병,11,0,11
M86,2019,대전,질병,6,1,7
M86,2019,부산,질병,10,0,10
M86,2019,서울,질병,20,3,23
M86,2019,인천,질병,1,0,1
M86,2020,광주,질병,5,6,11
M86,2020,대구,질병,5,2,7
M86,2020,대전,질병,10,1,11
M86,2020,서울,질병,22,14,36
M86,2021,광주,질병,3,4,7
M86,2021,대구,질병,12,3,15
M86,2021,대전,질병,6,0,6
M86,2021,부산,질병,3,4,7
M86,2021,서울,질병,7,10,17
M86,2021,인천,질병,1,0,1
M86,2022,광주,질병,2,0,2
M86,2022,대구,질병,10,0,10
M86,2022,대전,질병,3,1,4
M86,2022,부산,질병,5,0,5
M86,2022,서울,질병,29,23,52
M86,2023,광주,질병,6,4,10
M86,2023,대구,질병,11,1,12
M86,2023,대전,질병,15,5,20
M86,2023,부산,질병,7,1,8
M86,2023,서울,질병,29,10,39
M87,2019,광주,질병,2,0,2
M87,2019,대구,질병,6,6,12
M87,2019,대전,질병,12,6,18
M87,2019,부산,질병,19,9,28
M87,2019,서울,질병,24,26,50
M87,2019,인천,질병,0,1,1
M87,2020,광주,질병,10,0,10
M87,2020,대구,질병,9,4,13
M87,2020,대전,질병,4,6,10
M87,2020,서울,질병,10,13,23
M87,2020,인천,질병,0,1,1
M87,2021,광주,질병,1,3,4
M87,2021,대구,질병,5,8,13
M87,2021,대전,질병,12,6,18
M87,2021,부산,질병,5,2,7
M87,2021,서울,질병,6,13,19
M87,2021,인천,질병,0,3,3
M87,2022,광주,질병,1,3,4
M87,2022,대구,질병,6,3,9
M87,2022,대전,질병,9,5,14
M87,2022,부산,질병,3,1,4
M87,2022,서울,질병,11,5,16
M87,2022,인천,질병,0,1,1
M87,2023,광주,질병,4,2,6
M87,2023,대구,질병,2,5,7
M87,2023,대전,질병,10,3,13
M87,2023,부산,질병,2,1,3
M87,2023,서울,질병,9,14,23
M87,2023,인천,질병,1,1,2
M88,2020,대구,질병,0,1,1
M88,2023,부산,질병,1,0,1
M89,2019,광주,질병,2,0,2
M89,2019,대구,질병,1,0,1
M89,2019,부산,질병,20,5,25
M89,2019,서울,질병,33,5,38
M89,2020,광주,질병,4,3,7
M89,2020,대전,질병,1,0,1
M89,2020,서울,질병,16,11,27
M89,2021,광주,질병,3,0,3
M89,2021,대전,질병,1,1,2
M89,2021,부산,질병,9,1,10
M89,2021,서울,질병,2,0,2
M89,2021,인천,질병,1,0,1
M89,2022,대전,질병,1,0,1
M89,2022,부산,질병,3,1,4
M89,2022,서울,질병,2,2,4
M89,2023,대전,질병,2,0,2
M89,2023,부산,질병,3,0,3
M89,2023,서울,질병,6,9,15
M90,2019,서울,질병,9,2,11
M90,2020,서울,질병,7,1,8
M90,2021,서울,질병,7,6,13
M90,2022,서울,질병,2,4,6
M90,2023,서울,질병,1,0,1
M91,2020,서울,질병,0,1,1
M91,2022,서울,질병,0,1,1
M92,2019,서울,질병,1,0,1
M92,2020,광주,질병,1,0,1
M92,2021,부산,질병,2,0,2
M92,2021,서울,질병,2,0,2
M92,2022,대구,질병,1,0,1
M92,2022,부산,질병,1,0,1
M93,2019,광주,질병,1,0,1
M93,2019,대구,질병,2,1,3
M93,2019,부산,질병,1,0,1
M93,2019,서울,질병,2,0,2
M93,2020,광주,질병,2,0,2
M93,2020,대구,질병,0,2,2
M93,2020,서울,질병,2,1,3
M93,2021,대구,질병,5,2,7
M93,2021,부산,질병,0,2,2
M93,2021,서울,질병,1,1,2
M93,2022,광주,질병,0,1,1
M93,2022,대구,질병,2,0,2
M93,2022,서울,질병,2,1,3
M93,2023,광주,질병,0,2,2
M93,2023,대구,질병,1,1,2
M93,2023,서울,질병,2,0,2
M93,2023,인천,질병,0,2,2
M94,2019,대전,질병,2,0,2
M94,2019,부산,질병,3,0,3
M94,2019,서울,질병,1,1,2
M94,2020,서울,질병,3,1,4
M94,2021,대전,질병,2,0,2
M94,2021,부산,질병,6,0,6
M94,2021,서울,질병,0,1,1
M94,2022,대구,질병,1,0,1
M94,2022,대전,질병,1,0,1
M94,2022,부산,질병,1,0,1
M94,2022,서울,질병,1,0,1
M94,2023,광주,질병,0,2,2
M94,2023,부산,질병,1,0,1
M94,2023,서울,질병,0,2,2
M95,2019,대전,질병,1,0,1
M95,2019,부산,질병,1,0,1
M95,2020,서울,질병,1,1,2
M95,2021,서울,질병,2,2,4
M95,2022,서울,질병,3,3,6
M95,2023,대전,질병,1,0,1
M95,2023,부산,질병,1,0,1
M95,2023,서울,질병,19,11,30
M96,2019,광주,질병,18,11,29
M96,2019,대구,질병,19,5,24
M96,2019,대전,질병,154,23,177
M96,2019,부산,질병,136,13,149
M96,2019,서울,질병,125,49,174
M96,2019,인천,질병,1,3,4
M96,2020,광주,질병,23,9,32
M96,2020,대구,질병,18,6,24
M96,2020,대전,질병,140,15,155
M96,2020,서울,질병,92,49,141
M96,2020,인천,질병,17,6,23
M96,2021,광주,질병,16,8,24
M96,2021,대구,질병,18,4,22
M96,2021,대전,질병,112,14,126
M96,2021,부산,질병,124,12,136
M96,2021,서울,질병,70,28,98
M96,2021,인천,질병,22,5,27
M96,2022,광주,질병,6,3,9
M96,2022,대구,질병,43,5,48
M96,2022,대전,질병,125,17,142
M96,2022,부산,질병,140,13,153
M96,2022,서울,질병,71,49,120
M96,2022,인천,질병,5,3,8
M96,2023,광주,질병,15,0,15
M96,2023,대구,질병,45,9,54
M96,2023,대전,질병,201,29,230
M96,2023,부산,질병,169,18,187
M96,2023,서울,질병,141,79,220
M96,2023,인천,질병,7,2,9
M99,2019,광주,질병,0,1,1
M99,2019,대구,질병,0,2,2
M99,2019,서울,질병,5,0,5
M99,2020,광주,질병,5,2,7
M99,2021,광주,질병,5,3,8
M99,2021,서울,질병,2,0,2
M99,2022,광주,질병,1,2,3
M99,2022,서울,질병,5,14,19
M99,2023,광주,질병,1,0,1
M99,2023,서울,질병,27,13,40
N00,2019,부산,질병,3,0,3
N00,2019,서울,질병,0,1,1
N00,2020,서울,질병,1,1,2
N00,2022,서울,질병,0,1,1
N00,2023,서울,질병,2,0,2
N01,2019,광주,질병,1,0,1
N01,2022,서울,질병,5,0,5
N01,2023,서울,질병,1,5,6
N02,2019,서울,질병,10,2,12
N02,2020,서울,질병,9,2,11
N02,2021,서울,질병,5,4,9
N02,2022,부산,질병,1,0,1
N02,2022,서울,질병,5,5,10
N02,2023,서울,질병,6,4,10
N03,2019,서울,질병,2,1,3
N03,2020,서울,질병,3,1,4
N03,2021,서울,질병,1,1,2
N03,2022,대구,질병,1,0,1
N03,2022,서울,질병,0,1,1
N03,2023,대구,질병,1,1,2
N03,2023,서울,질병,1,0,1
N04,2019,광주,질병,1,1,2
N04,2019,부산,질병,0,1,1
N04,2019,서울,질병,3,4,7
N04,2020,광주,질병,0,1,1
N04,2020,대구,질병,0,1,1
N04,2020,서울,질병,4,3,7
N04,2021,광주,질병,1,1,2
N04,2021,대구,질병,1,2,3
N04,2021,서울,질병,6,3,9
N04,2022,광주,질병,0,1,1
N04,2022,서울,질병,1,0,1
N04,2023,광주,질병,0,2,2
N04,2023,대구,질병,1,0,1
N04,2023,서울,질병,0,2,2
N05,2019,광주,질병,2,2,4
N05,2019,서울,질병,2,4,6
N05,2020,광주,질병,1,0,1
N05,2020,대구,질병,0,1,1
N05,2020,서울,질병,10,7,17
N05,2021,광주,질병,0,3,3
N05,2021,서울,질병,6,2,8
N05,2022,광주,질병,1,0,1
N05,2022,부산,질병,1,0,1
N05,2022,서울,질병,4,4,8
N05,2023,서울,질병,9,5,14
N08,2019,광주,질병,2,0,2
N08,2019,대구,질병,30,28,58
N08,2019,대전,질병,41,11,52
N08,2019,부산,질병,4,0,4
N08,2019,서울,질병,556,221,777
N08,2020,대구,질병,44,14,58
N08,2020,대전,질병,36,16,52
N08,2020,서울,질병,842,331,1173
N08,2021,대구,질병,35,7,42
N08,2021,대전,질병,21,2,23
N08,2021,서울,질병,899,355,1254
N08,2022,대구,질병,23,3,26
N08,2022,대전,질병,19,7,26
N08,2022,서울,질병,980,382,1362
N08,2023,광주,질병,1,0,1
N08,2023,대구,질병,12,23,35
N08,2023,대전,질병,24,6,30
N08,2023,서울,질병,1242,451,1693
N10,2019,광주,질병,8,42,50
N10,2019,대구,질병,5,30,35
N10,2019,대전,질병,6,22,28
N10,2019,부산,질병,12,6,18
N10,2019,서울,질병,34,44,78
N10,2019,인천,질병,1,5,6
N10,2020,광주,질병,17,32,49
N10,2020,대구,질병,3,15,18
N10,2020,대전,질병,5,15,20
N10,2020,서울,질병,46,73,119
N10,2020,인천,질병,1,6,7
N10,2021,광주,질병,17,35,52
N10,2021,대구,질병,9,16,25
N10,2021,대전,질병,3,17,20
N10,2021,부산,질병,9,7,16
N10,2021,서울,질병,27,33,60
N10,2021,인천,질병,1,3,4
N10,2022,광주,질병,8,11,19
N10,2022,대구,질병,5,12,17
N10,2022,대전,질병,9,13,22
N10,2022,부산,질병,10,6,16
N10,2022,서울,질병,37,34,71
N10,2022,인천,질병,0,1,1
N10,2023,광주,질병,3,24,27
N10,2023,대구,질병,7,22,29
N10,2023,대전,질병,5,13,18
N10,2023,부산,질병,3,5,8
N10,2023,서울,질병,42,34,76
N10,2023,인천,질병,1,1,2
N11,2019,서울,질병,7,7,14
N11,2020,서울,질병,11,14,25
N11,2021,광주,질병,0,1,1
N11,2021,부산,질병,1,0,1
N11,2021,서울,질병,4,4,8
N11,2022,대전,질병,1,0,1
N11,2022,부산,질병,1,1,2
N11,2022,서울,질병,7,6,13
N11,2023,부산,질병,0,1,1
N11,2023,서울,질병,5,0,5
N12,2019,광주,질병,1,0,1
N12,2019,부산,질병,0,1,1
N12,2019,서울,질병,2,1,3
N12,2020,광주,질병,1,0,1
N12,2020,서울,질병,1,0,1
N12,2021,광주,질병,1,2,3
N12,2021,대전,질병,0,2,2
N12,2021,부산,질병,0,1,1
N12,2021,서울,질병,0,1,1
N12,2022,광주,질병,1,0,1
N12,2022,대구,질병,1,0,1
N12,2022,대전,질병,0,1,1
N12,2022,서울,질병,1,1,2
N12,2023,광주,질병,0,1,1
N12,2023,대전,질병,2,1,3
N12,2023,서울,질병,1,2,3
N13,2019,광주,질병,1,5,6
N13,2019,대구,질병,2,1,3
N13,2019,대전,질병,4,2,6
N13,2019,부산,질병,3,0,3
N13,2019,서울,질병,52,38,90
N13,2019,인천,질병,0,1,1
N13,2020,광주,질병,1,4,5
N13,2020,대전,질병,2,1,3
N13,2020,서울,질병,101,99,200
N13,2021,광주,질병,1,1,2
N13,2021,대구,질병,1,3,4
N13,2021,대전,질병,2,0,2
N13,2021,부산,질병,1,2,3
N13,2021,서울,질병,85,70,155
N13,2022,광주,질병,1,0,1
N13,2022,대구,질병,2,0,2
N13,2022,대전,질병,2,2,4
N13,2022,서울,질병,56,66,122
N13,2023,광주,질병,1,0,1
N13,2023,대구,질병,3,1,4
N13,2023,대전,질병,1,1,2
N13,2023,서울,질병,95,76,171
N14,2019,서울,질병,3,3,6
N14,2020,서울,질병,2,3,5
N14,2021,서울,질병,1,0,1
N14,2022,서울,질병,0,1,1
N14,2023,서울,질병,2,1,3
N15,2019,광주,질병,1,0,1
N15,2019,대전,질병,1,0,1
N15,2019,서울,질병,5,4,9
N15,2019,인천,질병,0,1,1
N15,2020,광주,질병,2,0,2
N15,2020,서울,질병,3,8,11
N15,2021,대전,질병,0,2,2
N15,2021,부산,질병,1,0,1
N15,2021,서울,질병,1,2,3
N15,2022,광주,질병,0,2,2
N15,2022,대구,질병,1,0,1
N15,2022,서울,질병,1,3,4
N15,2023,광주,질병,1,0,1
N15,2023,서울,질병,4,2,6
N17,2019,광주,질병,13,27,40
N17,2019,대구,질병,21,24,45
N17,2019,대전,질병,17,22,39
N17,2019,부산,질병,18,10,28
N17,2019,서울,질병,234,203,437
N17,2020,광주,질병,15,17,32
N17,2020,대구,질병,26,8,34
N17,2020,대전,질병,17,23,40
N17,2020,서울,질병,284,244,528
N17,2020,인천,질병,2,2,4
N17,2021,광주,질병,21,17,38
N17,2021,대구,질병,27,25,52
N17,2021,대전,질병,22,19,41
N17,2021,부산,질병,13,7,20
N17,2021,서울,질병,239,174,413
N17,2021,인천,질병,3,1,4
N17,2022,광주,질병,6,4,10
N17,2022,대구,질병,19,19,38
N17,2022,대전,질병,25,16,41
N17,2022,부산,질병,8,2,10
N17,2022,서울,질병,268,234,502
N17,2023,광주,질병,4,5,9
N17,2023,대구,질병,10,10,20
N17,2023,대전,질병,21,10,31
N17,2023,부산,질병,10,1,11
N17,2023,서울,질병,346,306,652
N18,2019,광주,질병,94,65,159
N18,2019,대구,질병,103,55,158
N18,2019,대전,질병,157,68,225
N18,2019,부산,질병,81,13,94
N18,2019,서울,질병,1016,524,1540
N18,2019,인천,질병,3,4,7
N18,2020,광주,질병,43,30,73
N18,2020,대구,질병,115,54,169
N18,2020,대전,질병,158,62,220
N18,2020,서울,질병,1226,598,1824
N18,2020,인천,질병,0,3,3
N18,2021,광주,질병,40,37,77
N18,2021,대구,질병,126,36,162
N18,2021,대전,질병,157,54,211
N18,2021,부산,질병,43,7,50
N18,2021,서울,질병,1299,618,1917
N18,2021,인천,질병,0,1,1
N18,2022,광주,질병,23,13,36
N18,2022,대구,질병,103,37,140
N18,2022,대전,질병,158,74,232
N18,2022,부산,질병,36,8,44
N18,2022,서울,질병,1388,673,2061
N18,2023,광주,질병,67,32,99
N18,2023,대구,질병,95,41,136
N18,2023,대전,질병,123,59,182
N18,2023,부산,질병,51,9,60
N18,2023,서울,질병,1786,790,2576
N18,2023,인천,질병,1,1,2
N19,2019,대구,질병,2,0,2
N19,2019,부산,질병,4,0,4
N19,2019,서울,질병,3,2,5
N19,2020,광주,질병,1,1,2
N19,2020,대구,질병,2,0,2
N19,2020,서울,질병,0,1,1
N19,2021,광주,질병,0,1,1
N19,2021,대구,질병,2,0,2
N19,2021,대전,질병,1,0,1
N19,2021,부산,질병,2,0,2
N19,2021,서울,질병,0,1,1
N19,2022,광주,질병,0,1,1
N19,2022,대구,질병,1,2,3
N19,2022,대전,질병,0,3,3
N19,2022,부산,질병,2,1,3
N19,2023,부산,질병,2,0,2
N20,2019,광주,질병,10,12,22
N20,2019,대구,질병,7,2,9
N20,2019,대전,질병,5,0,5
N20,2019,부산,질병,4,1,5
N20,2019,서울,질병,67,43,110
N20,2019,인천,질병,1,2,3
N20,2020,광주,질병,17,33,50
N20,2020,대구,질병,2,2,4
N20,2020,대전,질병,3,3,6
N20,2020,서울,질병,38,39,77
N20,2020,인천,질병,0,6,6
N20,2021,광주,질병,25,39,64
N20,2021,대구,질병,2,4,6
N20,2021,대전,질병,7,1,8
N20,2021,부산,질병,1,3,4
N20,2021,서울,질병,38,30,68
N20,2021,인천,질병,0,1,1
N20,2022,광주,질병,9,21,30
N20,2022,대구,질병,2,2,4
N20,2022,대전,질병,3,1,4
N20,2022,부산,질병,7,3,10
N20,2022,서울,질병,19,11,30
N20,2022,인천,질병,0,1,1
N20,2023,광주,질병,12,38,50
N20,2023,대구,질병,5,2,7
N20,2023,대전,질병,3,0,3
N20,2023,부산,질병,3,1,4
N20,2023,서울,질병,31,32,63
N20,2023,인천,질병,3,4,7
N21,2019,광주,질병,2,5,7
N21,2019,대구,질병,5,6,11
N21,2019,대전,질병,4,1,5
N21,2019,서울,질병,23,20,43
N21,2019,인천,질병,1,4,5
N21,2020,광주,질병,3,9,12
N21,2020,대구,질병,4,2,6
N21,2020,서울,질병,27,20,47
N21,2020,인천,질병,1,6,7
N21,2021,광주,질병,3,8,11
N21,2021,대구,질병,3,7,10
N21,2021,대전,질병,1,0,1
N21,2021,부산,질병,3,2,5
N21,2021,서울,질병,21,24,45
N21,2021,인천,질병,1,3,4
N21,2022,광주,질병,0,8,8
N21,2022,대구,질병,5,5,10
N21,2022,부산,질병,3,2,5
N21,2022,서울,질병,21,21,42
N21,2022,인천,질병,1,2,3
N21,2023,광주,질병,5,5,10
N21,2023,대구,질병,3,3,6
N21,2023,대전,질병,2,0,2
N21,2023,부산,질병,6,1,7
N21,2023,서울,질병,17,30,47
N21,2023,인천,질병,1,3,4
N25,2019,광주,질병,0,1,1
N25,2019,서울,질병,1,1,2
N25,2020,서울,질병,1,0,1
N25,2021,서울,질병,1,1,2
N25,2022,서울,질병,0,1,1
N25,2023,부산,질병,1,0,1
N25,2023,서울,질병,1,2,3
N26,2020,서울,질병,2,0,2
N26,2021,서울,질병,1,2,3
N26,2022,서울,질병,0,1,1
N26,2023,서울,질병,0,2,2
N28,2019,광주,질병,1,5,6
N28,2019,대구,질병,1,1,2
N28,2019,대전,질병,1,0,1
N28,2019,부산,질병,0,1,1
N28,2019,서울,질병,53,36,89
N28,2020,광주,질병,3,3,6
N28,2020,대구,질병,2,3,5
N28,2020,대전,질병,1,1,2
N28,2020,서울,질병,31,27,58
N28,2020,인천,질병,1,0,1
N28,2021,광주,질병,2,1,3
N28,2021,대구,질병,1,0,1
N28,2021,대전,질병,1,0,1
N28,2021,부산,질병,1,0,1
N28,2021,서울,질병,35,31,66
N28,2022,광주,질병,1,1,2
N28,2022,대구,질병,2,1,3
N28,2022,대전,질병,1,1,2
N28,2022,서울,질병,29,27,56
N28,2023,광주,질병,1,2,3
N28,2023,대구,질병,1,0,1
N28,2023,서울,질병,45,27,72
N29,2019,서울,질병,1,0,1
N30,2019,광주,질병,5,5,10
N30,2019,대구,질병,12,9,21
N30,2019,대전,질병,0,1,1
N30,2019,부산,질병,8,1,9
N30,2019,서울,질병,26,22,48
N30,2019,인천,질병,11,7,18
N30,2020,광주,질병,2,12,14
N30,2020,대구,질병,7,4,11
N30,2020,대전,질병,0,1,1
N30,2020,서울,질병,42,30,72
N30,2020,인천,질병,8,14,22
N30,2021,광주,질병,4,8,12
N30,2021,대구,질병,6,5,11
N30,2021,대전,질병,1,0,1
N30,2021,부산,질병,4,1,5
N30,2021,서울,질병,51,38,89
N30,2021,인천,질병,7,7,14
N30,2022,광주,질병,3,5,8
N30,2022,대구,질병,14,3,17
N30,2022,대전,질병,0,3,3
N30,2022,부산,질병,3,1,4
N30,2022,서울,질병,61,30,91
N30,2022,인천,질병,1,5,6
N30,2023,광주,질병,7,10,17
N30,2023,대구,질병,11,2,13
N30,2023,대전,질병,1,1,2
N30,2023,부산,질병,3,0,3
N30,2023,서울,질병,57,30,87
N30,2023,인천,질병,1,13,14
N31,2019,광주,질병,4,1,5
N31,2019,대구,질병,17,15,32
N31,2019,대전,질병,27,8,35
N31,2019,부산,질병,25,2,27
N31,2019,서울,질병,33,16,49
N31,2019,인천,질병,27,32,59
N31,2020,광주,질병,4,1,5
N31,2020,대구,질병,14,16,30
N31,2020,대전,질병,27,6,33
N31,2020,서울,질병,42,36,78
N31,2020,인천,질병,46,46,92
N31,2021,광주,질병,6,3,9
N31,2021,대구,질병,21,14,35
N31,2021,대전,질병,19,5,24
N31,2021,부산,질병,27,0,27
N31,2021,서울,질병,18,19,37
N31,2021,인천,질병,52,41,93
N31,2022,광주,질병,2,3,5
N31,2022,대구,질병,13,9,22
N31,2022,대전,질병,17,7,24
N31,2022,부산,질병,23,2,25
N31,2022,서울,질병,12,9,21
N31,2022,인천,질병,15,30,45
N31,2023,광주,질병,5,2,7
N31,2023,대구,질병,15,1,16
N31,2023,대전,질병,34,4,38
N31,2023,부산,질병,27,5,32
N31,2023,서울,질병,33,26,59
N31,2023,인천,질병,15,25,40
N32,2019,광주,질병,6,0,6
N32,2019,대구,질병,7,2,9
N32,2019,대전,질병,3,8,11
N32,2019,부산,질병,3,0,3
N32,2019,서울,질병,18,10,28
N32,2020,광주,질병,3,0,3
N32,2020,대구,질병,4,3,7
N32,2020,서울,질병,25,26,51
N32,2021,광주,질병,2,1,3
N32,2021,대구,질병,2,0,2
N32,2021,대전,질병,2,6,8
N32,2021,서울,질병,40,27,67
N32,2022,광주,질병,5,0,5
N32,2022,대구,질병,3,0,3
N32,2022,대전,질병,0,2,2
N32,2022,부산,질병,0,2,2
N32,2022,서울,질병,26,17,43
N32,2023,광주,질병,4,3,7
N32,2023,대구,질병,1,0,1
N32,2023,부산,질병,1,0,1
N32,2023,서울,질병,37,19,56
N33,2019,대구,질병,0,1,1
N33,2019,부산,질병,1,0,1
N33,2019,서울,질병,0,1,1
N34,2019,광주,질병,0,1,1
N34,2019,부산,질병,1,0,1
N34,2019,서울,질병,2,3,5
N34,2020,서울,질병,4,5,9
N34,2021,서울,질병,4,2,6
N34,2022,광주,질병,0,1,1
N34,2022,서울,질병,2,2,4
N34,2023,서울,질병,3,1,4
N35,2019,광주,질병,0,2,2
N35,2019,대구,질병,10,1,11
N35,2019,대전,질병,1,2,3
N35,2019,부산,질병,5,0,5
N35,2019,서울,질병,28,16,44
N35,2020,광주,질병,1,0,1
N35,2020,대구,질병,7,3,10
N35,2020,대전,질병,4,0,4
N35,2020,서울,질병,32,18,50
N35,2021,광주,질병,13,3,16
N35,2021,대구,질병,7,3,10
N35,2021,대전,질병,1,0,1
N35,2021,부산,질병,2,2,4
N35,2021,서울,질병,30,21,51
N35,2021,인천,질병,1,0,1
N35,2022,광주,질병,7,1,8
N35,2022,대구,질병,8,1,9
N35,2022,대전,질병,1,0,1
N35,2022,부산,질병,1,0,1
N35,2022,서울,질병,33,13,46
N35,2023,광주,질병,5,0,5
N35,2023,대구,질병,9,3,12
N35,2023,대전,질병,2,1,3
N35,2023,부산,질병,8,2,10
N35,2023,서울,질병,38,9,47
N36,2019,서울,질병,3,3,6
N36,2019,인천,질병,0,1,1
N36,2020,광주,질병,0,1,1
N36,2020,서울,질병,2,3,5
N36,2021,광주,질병,1,1,2
N36,2021,대구,질병,1,0,1
N36,2021,서울,질병,6,3,9
N36,2022,광주,질병,0,1,1
N36,2022,부산,질병,0,1,1
N36,2022,서울,질병,2,3,5
N36,2023,광주,질병,1,0,1
N36,2023,대전,질병,1,0,1
N36,2023,서울,질병,2,0,2
N37,2019,서울,질병,1,2,3
N37,2020,서울,질병,3,3,6
N37,2021,광주,질병,1,0,1
N37,2021,서울,질병,2,1,3
N37,2022,서울,질병,1,0,1
N37,2023,서울,질병,4,2,6
N39,2019,광주,질병,8,37,45
N39,2019,대구,질병,80,98,178
N39,2019,대전,질병,38,27,65
N39,2019,부산,질병,19,3,22
N39,2019,서울,질병,260,276,536
N39,2019,인천,질병,0,2,2
N39,2020,광주,질병,16,37,53
N39,2020,대구,질병,66,47,113
N39,2020,대전,질병,33,25,58
N39,2020,서울,질병,283,287,570
N39,2020,인천,질병,0,5,5
N39,2021,광주,질병,16,25,41
N39,2021,대구,질병,41,40,81
N39,2021,대전,질병,28,28,56
N39,2021,부산,질병,16,1,17
N39,2021,서울,질병,182,201,383
N39,2021,인천,질병,0,5,5
N39,2022,광주,질병,17,13,30
N39,2022,대구,질병,48,39,87
N39,2022,대전,질병,25,24,49
N39,2022,부산,질병,21,0,21
N39,2022,서울,질병,204,253,457
N39,2022,인천,질병,0,5,5
N39,2023,광주,질병,22,32,54
N39,2023,대구,질병,58,48,106
N39,2023,대전,질병,21,19,40
N39,2023,부산,질병,19,4,23
N39,2023,서울,질병,229,304,533
N39,2023,인천,질병,1,5,6
N40,2019,광주,질병,239,166,405
N40,2019,대구,질병,240,120,360
N40,2019,대전,질병,333,119,452
N40,2019,부산,질병,130,81,211
N40,2019,서울,질병,593,439,1032
N40,2019,인천,질병,31,18,49
N40,2020,광주,질병,278,215,493
N40,2020,대구,질병,172,87,259
N40,2020,대전,질병,238,75,313
N40,2020,서울,질병,603,399,1002
N40,2020,인천,질병,33,22,55
N40,2021,광주,질병,279,236,515
N40,2021,대구,질병,138,84,222
N40,2021,대전,질병,224,72,296
N40,2021,부산,질병,97,73,170
N40,2021,서울,질병,549,357,906
N40,2021,인천,질병,40,39,79
N40,2022,광주,질병,333,263,596
N40,2022,대구,질병,123,55,178
N40,2022,대전,질병,160,56,216
N40,2022,부산,질병,173,97,270
N40,2022,서울,질병,416,266,682
N40,2022,인천,질병,42,29,71
N40,2023,광주,질병,399,308,707
N40,2023,대구,질병,83,43,126
N40,2023,대전,질병,99,32,131
N40,2023,부산,질병,200,153,353
N40,2023,서울,질병,432,320,752
N40,2023,인천,질병,72,41,113
N41,2019,광주,질병,5,2,7
N41,2019,대구,질병,1,2,3
N41,2019,대전,질병,1,2,3
N41,2019,부산,질병,7,0,7
N41,2019,서울,질병,16,9,25
N41,2019,인천,질병,3,1,4
N41,2020,광주,질병,5,3,8
N41,2020,대구,질병,1,1,2
N41,2020,대전,질병,1,0,1
N41,2020,서울,질병,23,19,42
N41,2020,인천,질병,1,5,6
N41,2021,광주,질병,8,9,17
N41,2021,대전,질병,0,1,1
N41,2021,부산,질병,12,1,13
N41,2021,서울,질병,14,16,30
N41,2022,광주,질병,6,4,10
N41,2022,대구,질병,3,0,3
N41,2022,대전,질병,1,0,1
N41,2022,부산,질병,8,1,9
N41,2022,서울,질병,13,12,25
N41,2023,광주,질병,6,8,14
N41,2023,대구,질병,4,0,4
N41,2023,대전,질병,0,1,1
N41,2023,부산,질병,6,4,10
N41,2023,서울,질병,17,21,38
N42,2019,서울,질병,35,41,76
N42,2020,광주,질병,1,0,1
N42,2020,대전,질병,1,0,1
N42,2020,서울,질병,10,2,12
N42,2021,대전,질병,1,0,1
N42,2021,서울,질병,5,2,7
N42,2022,광주,질병,0,1,1
N42,2022,서울,질병,1,3,4
N42,2023,대전,질병,2,0,2
N42,2023,서울,질병,7,2,9
N43,2019,광주,질병,2,5,7
N43,2019,대구,질병,9,3,12
N43,2019,대전,질병,1,0,1
N43,2019,부산,질병,4,2,6
N43,2019,서울,질병,11,10,21
N43,2020,광주,질병,2,7,9
N43,2020,대구,질병,5,0,5
N43,2020,대전,질병,0,1,1
N43,2020,서울,질병,6,9,15
N43,2020,인천,질병,2,0,2
N43,2021,광주,질병,3,9,12
N43,2021,대구,질병,3,6,9
N43,2021,대전,질병,1,1,2
N43,2021,부산,질병,2,1,3
N43,2021,서울,질병,5,16,21
N43,2021,인천,질병,1,2,3
N43,2022,광주,질병,1,11,12
N43,2022,대구,질병,4,1,5
N43,2022,대전,질병,0,1,1
N43,2022,부산,질병,2,0,2
N43,2022,서울,질병,10,4,14
N43,2022,인천,질병,1,0,1
N43,2023,광주,질병,3,3,6
N43,2023,대구,질병,2,1,3
N43,2023,부산,질병,2,0,2
N43,2023,서울,질병,10,11,21
N43,2023,인천,질병,0,3,3
N45,2019,광주,질병,6,2,8
N45,2019,대구,질병,5,4,9
N45,2019,대전,질병,5,1,6
N45,2019,부산,질병,3,2,5
N45,2019,서울,질병,11,3,14
N45,2019,인천,질병,1,3,4
N45,2020,광주,질병,4,7,11
N45,2020,대구,질병,1,5,6
N45,2020,대전,질병,1,0,1
N45,2020,서울,질병,8,2,10
N45,2020,인천,질병,3,5,8
N45,2021,광주,질병,4,3,7
N45,2021,대구,질병,3,1,4
N45,2021,대전,질병,4,1,5
N45,2021,부산,질병,11,1,12
N45,2021,서울,질병,10,2,12
N45,2021,인천,질병,3,2,5
N45,2022,광주,질병,5,4,9
N45,2022,대구,질병,3,0,3
N45,2022,대전,질병,3,0,3
N45,2022,부산,질병,4,2,6
N45,2022,서울,질병,10,4,14
N45,2022,인천,질병,1,0,1
N45,2023,광주,질병,7,7,14
N45,2023,대구,질병,1,1,2
N45,2023,대전,질병,0,1,1
N45,2023,부산,질병,1,0,1
N45,2023,서울,질병,10,8,18
N45,2023,인천,질병,1,0,1
N46,2020,광주,질병,0,1,1
N47,2019,서울,질병,3,1,4
N47,2020,서울,질병,3,0,3
N47,2021,광주,질병,0,2,2
N47,2021,대구,질병,3,0,3
N47,2021,서울,질병,1,1,2
N47,2022,대구,질병,1,0,1
N47,2022,서울,질병,3,1,4
N47,2023,대구,질병,3,0,3
N47,2023,서울,질병,2,2,4
N47,2023,인천,질병,0,1,1
N48,2019,광주,질병,2,0,2
N48,2019,대구,질병,1,0,1
N48,2019,부산,질병,9,0,9
N48,2019,서울,질병,21,9,30
N48,2019,인천,질병,1,0,1
N48,2020,광주,질병,1,1,2
N48,2020,대구,질병,1,1,2
N48,2020,서울,질병,17,7,24
N48,2020,인천,질병,0,1,1
N48,2021,광주,질병,0,2,2
N48,2021,대구,질병,1,0,1
N48,2021,대전,질병,1,0,1
N48,2021,부산,질병,11,0,11
N48,2021,서울,질병,18,5,23
N48,2022,대구,질병,1,0,1
N48,2022,부산,질병,2,0,2
N48,2022,서울,질병,18,12,30
N48,2023,광주,질병,2,0,2
N48,2023,대구,질병,1,0,1
N48,2023,부산,질병,5,0,5
N48,2023,서울,질병,23,8,31
N49,2019,광주,질병,0,1,1
N49,2019,서울,질병,8,2,10
N49,2019,인천,질병,0,1,1
N49,2020,광주,질병,1,0,1
N49,2020,서울,질병,7,4,11
N49,2020,인천,질병,1,0,1
N49,2021,광주,질병,0,1,1
N49,2021,대전,질병,2,0,2
N49,2021,부산,질병,3,0,3
N49,2021,서울,질병,5,1,6
N49,2022,대구,질병,1,0,1
N49,2022,서울,질병,5,4,9
N49,2022,인천,질병,2,0,2
N49,2023,부산,질병,1,0,1
N49,2023,서울,질병,12,6,18
N49,2023,인천,질병,1,1,2
N50,2019,서울,질병,6,3,9
N50,2020,광주,질병,1,0,1
N50,2020,서울,질병,9,7,16
N50,2021,광주,질병,0,1,1
N50,2021,서울,질병,19,5,24
N50,2022,광주,질병,0,1,1
N50,2022,서울,질병,6,3,9
N50,2023,광주,질병,0,1,1
N50,2023,서울,질병,11,5,16
N51,2019,대구,질병,1,0,1
N51,2019,부산,질병,1,0,1
N51,2019,서울,질병,1,0,1
N51,2021,대구,질병,1,0,1
N51,2022,대구,질병,1,0,1
N51,2023,서울,질병,2,0,2
N60,2019,서울,질병,1,8,9
N60,2020,서울,질병,0,19,19
N60,2021,서울,질병,2,25,27
N60,2022,서울,질병,0,26,26
N60,2023,서울,질병,0,27,27
N61,2019,대전,질병,0,2,2
N61,2019,서울,질병,0,4,4
N61,2021,서울,질병,0,1,1
N61,2022,서울,질병,1,1,2
N62,2019,광주,질병,1,0,1
N62,2019,대구,질병,3,0,3
N62,2019,서울,질병,1,10,11
N62,2020,광주,질병,2,0,2
N62,2020,대구,질병,2,0,2
N62,2020,서울,질병,4,13,17
N62,2021,대구,질병,1,0,1
N62,2021,서울,질병,2,6,8
N62,2022,서울,질병,4,5,9
N62,2023,광주,질병,2,0,2
N62,2023,서울,질병,5,2,7
N63,2019,서울,질병,0,4,4
N63,2020,광주,질병,0,3,3
N63,2020,서울,질병,0,1,1
N63,2021,서울,질병,1,1,2
N63,2022,광주,질병,0,1,1
N63,2022,서울,질병,0,1,1
N64,2019,서울,질병,0,3,3
N64,2020,서울,질병,0,1,1
N64,2021,서울,질병,2,17,19
N64,2022,서울,질병,0,5,5
N64,2023,서울,질병,0,22,22
N70,2019,서울,질병,0,4,4
N70,2020,서울,질병,0,6,6
N70,2021,서울,질병,0,1,1
N70,2022,광주,질병,0,1,1
N70,2022,서울,질병,0,7,7
N70,2023,대전,질병,0,1,1
N70,2023,서울,질병,0,6,6
N71,2019,광주,질병,0,1,1
N71,2019,서울,질병,0,7,7
N71,2020,대구,질병,0,1,1
N71,2020,서울,질병,0,3,3
N71,2021,광주,질병,0,1,1
N71,2021,서울,질병,0,1,1
N71,2022,서울,질병,0,7,7
N71,2023,서울,질병,0,10,10
N72,2019,서울,질병,0,36,36
N72,2020,서울,질병,0,35,35
N72,2021,서울,질병,0,25,25
N72,2022,서울,질병,1,40,41
N72,2023,서울,질병,1,42,43
N73,2019,광주,질병,0,1,1
N73,2019,서울,질병,0,7,7
N73,2020,서울,질병,0,10,10
N73,2021,부산,질병,0,1,1
N73,2021,서울,질병,0,8,8
N73,2022,서울,질병,1,4,5
N73,2023,서울,질병,0,13,13
N74,2021,광주,질병,0,1,1
N74,2023,대전,질병,0,1,1
N75,2019,서울,질병,0,1,1
N75,2020,서울,질병,1,3,4
N75,2022,서울,질병,0,2,2
N75,2023,서울,질병,0,1,1
N76,2019,서울,질병,0,6,6
N76,2020,서울,질병,0,1,1
N76,2021,서울,질병,0,4,4
N76,2022,서울,질병,1,1,2
N76,2023,서울,질병,0,5,5
N77,2019,서울,질병,0,1,1
N77,2020,서울,질병,0,2,2
N77,2021,서울,질병,0,2,2
N77,2022,서울,질병,0,6,6
N77,2023,서울,질병,0,4,4
N80,2019,서울,질병,0,13,13
N80,2020,서울,질병,0,18,18
N80,2021,서울,질병,0,18,18
N80,2022,서울,질병,0,23,23
N80,2023,대전,질병,0,1,1
N80,2023,서울,질병,0,28,28
N81,2019,서울,질병,1,32,33
N81,2020,서울,질병,0,23,23
N81,2021,서울,질병,0,24,24
N81,2022,서울,질병,0,30,30
N81,2023,대전,질병,0,1,1
N81,2023,서울,질병,1,29,30
N82,2019,서울,질병,0,1,1
N82,2021,서울,질병,0,2,2
N82,2022,서울,질병,0,2,2
N83,2019,서울,질병,0,28,28
N83,2020,서울,질병,0,37,37
N83,2021,서울,질병,0,25,25
N83,2022,서울,질병,1,34,35
N83,2023,대전,질병,0,1,1
N83,2023,서울,질병,0,36,36
N84,2019,서울,질병,1,54,55
N84,2020,서울,질병,2,40,42
N84,2021,서울,질병,0,29,29
N84,2022,서울,질병,0,40,40
N84,2023,서울,질병,1,51,52
N85,2019,서울,질병,0,48,48
N85,2020,서울,질병,1,46,47
N85,2021,서울,질병,0,19,19
N85,2022,서울,질병,0,29,29
N85,2023,서울,질병,1,56,57
N86,2022,서울,질병,0,1,1
N87,2019,서울,질병,0,14,14
N87,2020,서울,질병,0,11,11
N87,2021,서울,질병,0,7,7
N87,2022,서울,질병,0,9,9
N87,2023,서울,질병,0,14,14
N88,2019,서울,질병,0,1,1
N88,2020,서울,질병,2,1,3
N88,2021,부산,질병,0,1,1
N88,2021,서울,질병,0,6,6
N88,2022,서울,질병,0,5,5
N88,2023,부산,질병,0,1,1
N88,2023,서울,질병,0,7,7
N89,2020,서울,질병,0,3,3
N89,2023,서울,질병,0,3,3
N90,2019,서울,질병,0,1,1
N90,2021,서울,질병,0,3,3
N90,2022,서울,질병,0,4,4
N90,2023,서울,질병,0,4,4
N91,2020,서울,질병,0,1,1
N91,2021,서울,질병,0,1,1
N92,2019,서울,질병,0,1,1
N92,2020,서울,질병,0,2,2
N92,2021,서울,질병,0,3,3
N92,2022,서울,질병,0,1,1
N93,2019,서울,질병,0,6,6
N93,2020,서울,질병,0,2,2
N93,2021,서울,질병,0,1,1
N93,2022,서울,질병,0,3,3
N93,2023,서울,질병,0,3,3
N94,2022,서울,질병,0,1,1
N94,2023,서울,질병,0,1,1
N95,2019,서울,질병,0,4,4
N95,2020,서울,질병,0,4,4
N95,2021,서울,질병,0,2,2
N95,2022,서울,질병,1,1,2
N95,2023,서울,질병,0,5,5
N99,2019,서울,질병,5,8,13
N99,2020,서울,질병,19,19,38
N99,2021,서울,질병,23,11,34
N99,2022,서울,질병,28,27,55
N99,2023,서울,질병,42,17,59
O02,2020,서울,질병,0,2,2
O02,2021,서울,질병,0,1,1
O10,2019,서울,질병,1,0,1
O10,2020,서울,질병,1,0,1
O10,2023,서울,질병,1,0,1
O23,2021,서울,질병,0,1,1
O24,2021,대구,질병,0,1,1
O24,2021,서울,질병,0,1,1
O34,2020,서울,질병,0,2,2
O82,2020,서울,질병,0,2,2
O92,2020,광주,질병,0,1,1
O99,2020,서울,질병,0,1,1
Q04,2019,대구,질병,1,0,1
Q04,2019,부산,질병,1,0,1
Q04,2020,광주,질병,0,1,1
Q04,2021,부산,질병,0,3,3
Q10,2022,서울,질병,0,1,1
Q13,2019,서울,질병,0,1,1
Q14,2020,서울,질병,0,1,1
Q16,2021,서울,질병,1,0,1
Q18,2019,서울,질병,2,0,2
Q18,2020,서울,질병,0,1,1
Q18,2021,광주,질병,0,1,1
Q18,2021,서울,질병,0,2,2
Q18,2022,서울,질병,0,5,5
Q18,2023,서울,질병,0,1,1
Q21,2019,서울,질병,1,0,1
Q21,2020,대구,질병,1,1,2
Q21,2021,대구,질병,1,0,1
Q21,2021,서울,질병,2,1,3
Q21,2022,서울,질병,1,1,2
Q21,2023,서울,질병,1,0,1
Q23,2019,광주,질병,0,2,2
Q23,2019,서울,질병,0,1,1
Q23,2020,광주,질병,1,0,1
Q23,2020,서울,질병,6,4,10
Q23,2021,광주,질병,1,0,1
Q23,2021,서울,질병,3,9,12
Q23,2022,부산,질병,1,0,1
Q23,2022,서울,질병,10,4,14
Q23,2023,광주,질병,1,0,1
Q23,2023,서울,질병,8,6,14
Q24,2020,서울,질병,3,0,3
Q24,2021,대구,질병,0,1,1
Q24,2023,광주,질병,1,1,2
Q24,2023,서울,질병,3,5,8
Q25,2019,대전,질병,0,1,1
Q25,2021,대구,질병,0,1,1
Q26,2023,대구,질병,0,1,1
Q27,2019,광주,질병,1,0,1
Q27,2020,광주,질병,1,0,1
Q27,2022,광주,질병,1,0,1
Q27,2022,서울,질병,3,1,4
Q27,2023,광주,질병,1,1,2
Q28,2019,광주,질병,2,0,2
Q28,2019,서울,질병,2,1,3
Q28,2020,광주,질병,2,0,2
Q28,2020,서울,질병,3,3,6
Q28,2021,서울,질병,1,2,3
Q28,2022,광주,질병,2,1,3
Q28,2022,서울,질병,0,1,1
Q28,2023,광주,질병,1,0,1
Q28,2023,서울,질병,1,0,1
Q31,2020,서울,질병,0,1,1
Q38,2022,서울,질병,1,0,1
Q39,2020,서울,질병,1,0,1
Q39,2023,서울,질병,1,0,1
Q40,2019,서울,질병,0,1,1
Q40,2020,서울,질병,1,1,2
Q40,2023,대전,질병,1,0,1
Q40,2023,서울,질병,1,0,1
Q43,2019,서울,질병,0,1,1
Q43,2020,서울,질병,1,1,2
Q44,2019,대구,질병,0,1,1
Q44,2020,대구,질병,1,0,1
Q44,2021,광주,질병,0,1,1
Q44,2021,서울,질병,0,1,1
Q44,2022,광주,질병,1,1,2
Q44,2022,부산,질병,1,0,1
Q44,2023,서울,질병,1,0,1
Q45,2019,서울,질병,0,2,2
Q45,2020,서울,질병,1,1,2
Q45,2021,부산,질병,0,1,1
Q45,2021,서울,질병,0,1,1
Q45,2022,서울,질병,0,2,2
Q45,2023,서울,질병,0,1,1
Q50,2021,서울,질병,0,2,2
Q50,2022,서울,질병,0,3,3
Q50,2023,서울,질병,0,2,2
Q53,2020,서울,질병,1,0,1
Q53,2022,서울,질병,1,0,1
Q54,2020,서울,질병,0,1,1
Q54,2022,대전,질병,0,1,1
Q55,2023,서울,질병,1,0,1
Q61,2019,광주,질병,1,1,2
Q61,2019,대구,질병,1,0,1
Q61,2019,대전,질병,0,1,1
Q61,2019,부산,질병,1,0,1
Q61,2019,서울,질병,8,5,13
Q61,2020,서울,질병,12,5,17
Q61,2021,대구,질병,0,1,1
Q61,2021,서울,질병,10,2,12
Q61,2022,서울,질병,5,3,8
Q61,2023,광주,질병,1,1,2
Q61,2023,대구,질병,0,1,1
Q61,2023,서울,질병,6,3,9
Q62,2021,서울,질병,0,1,1
Q63,2020,서울,질병,0,1,1
Q63,2021,서울,질병,0,5,5
Q63,2023,서울,질병,1,1,2
Q64,2020,대구,질병,0,1,1
Q64,2020,서울,질병,0,1,1
Q64,2020,인천,질병,1,0,1
Q65,2019,서울,질병,1,1,2
Q65,2021,광주,질병,1,0,1
Q65,2021,서울,질병,0,1,1
Q66,2019,대구,질병,4,0,4
Q66,2020,대구,질병,0,2,2
Q66,2020,서울,질병,1,0,1
Q66,2021,대구,질병,0,1,1
Q66,2022,부산,질병,1,0,1
Q66,2023,광주,질병,1,0,1
Q66,2023,부산,질병,3,0,3
Q68,2023,대구,질병,0,1,1
Q68,2023,서울,질병,1,0,1
Q69,2023,대구,질병,1,0,1
Q70,2019,서울,질병,1,0,1
Q70,2021,서울,질병,1,0,1
Q72,2023,서울,질병,1,0,1
Q74,2019,서울,질병,0,1,1
Q74,2022,대구,질병,1,0,1
Q76,2019,서울,질병,0,1,1
Q76,2021,부산,질병,0,1,1
Q79,2019,대전,질병,0,1,1
Q79,2020,서울,질병,1,1,2
Q82,2019,서울,질병,1,1,2
Q82,2022,서울,질병,1,0,1
Q83,2020,광주,질병,0,1,1
Q85,2019,서울,질병,2,0,2
Q85,2020,대구,질병,0,1,1
Q85,2020,서울,질병,1,2,3
Q85,2021,대전,질병,1,0,1
Q85,2021,서울,질병,1,3,4
Q85,2022,서울,질병,0,1,1
Q85,2023,서울,질병,2,0,2
Q87,2019,서울,질병,0,1,1
Q87,2022,서울,질병,1,1,2
Q87,2023,서울,질병,0,1,1
Q89,2019,서울,질병,4,0,4
Q89,2020,광주,질병,1,0,1
Q89,2020,서울,질병,2,2,4
Q89,2021,서울,질병,1,3,4
Q89,2022,서울,질병,3,0,3
Q89,2023,서울,질병,1,1,2
Q99,2021,광주,질병,1,0,1
Q99,2022,광주,질병,1,0,1
R00,2019,광주,질병,1,4,5
R00,2019,대구,질병,6,2,8
R00,2019,대전,질병,2,0,2
R00,2019,부산,질병,8,1,9
R00,2019,서울,질병,22,29,51
R00,2020,광주,질병,1,4,5
R00,2020,대구,질병,4,5,9
R00,2020,서울,질병,29,17,46
R00,2021,광주,질병,2,0,2
R00,2021,대구,질병,5,6,11
R00,2021,부산,질병,5,0,5
R00,2021,서울,질병,14,11,25
R00,2022,광주,질병,1,0,1
R00,2022,대구,질병,6,4,10
R00,2022,대전,질병,1,0,1
R00,2022,부산,질병,3,2,5
R00,2022,서울,질병,20,20,40
R00,2023,대구,질병,4,4,8
R00,2023,대전,질병,1,1,2
R00,2023,부산,질병,2,1,3
R00,2023,서울,질병,38,18,56
R01,2021,서울,질병,0,1,1
R01,2023,부산,질병,0,1,1
R02,2019,광주,질병,0,3,3
R02,2019,대구,질병,1,0,1
R02,2019,부산,질병,1,0,1
R02,2019,서울,질병,2,3,5
R02,2020,광주,질병,0,1,1
R02,2020,대구,질병,4,1,5
R02,2020,서울,질병,1,1,2
R02,2021,대구,질병,3,1,4
R02,2021,부산,질병,2,1,3
R02,2021,서울,질병,0,1,1
R02,2022,광주,질병,2,0,2
R02,2022,대구,질병,3,3,6
R02,2022,부산,질병,2,0,2
R02,2022,서울,질병,1,2,3
R02,2022,인천,질병,1,0,1
R02,2023,광주,질병,6,1,7
R02,2023,대구,질병,5,0,5
R02,2023,부산,질병,2,0,2
R03,2019,서울,질병,1,0,1
R03,2020,광주,질병,0,2,2
R03,2020,대구,질병,1,1,2
R03,2020,서울,질병,1,0,1
R03,2021,부산,질병,4,0,4
R03,2021,서울,질병,2,1,3
R03,2022,광주,질병,0,1,1
R03,2022,부산,질병,1,1,2
R03,2022,서울,질병,0,11,11
R03,2023,광주,질병,0,3,3
R03,2023,대전,질병,1,0,1
R03,2023,서울,질병,1,1,2
R04,2019,광주,질병,2,2,4
R04,2019,대구,질병,5,0,5
R04,2019,대전,질병,7,3,10
R04,2019,부산,질병,3,2,5
R04,2019,서울,질병,20,18,38
R04,2019,인천,질병,0,1,1
R04,2020,광주,질병,2,5,7
R04,2020,대구,질병,3,0,3
R04,2020,대전,질병,5,2,7
R04,2020,서울,질병,22,20,42
R04,2021,광주,질병,4,2,6
R04,2021,대구,질병,2,0,2
R04,2021,대전,질병,2,1,3
R04,2021,부산,질병,0,1,1
R04,2021,서울,질병,12,12,24
R04,2022,대구,질병,5,2,7
R04,2022,대전,질병,2,0,2
R04,2022,부산,질병,2,1,3
R04,2022,서울,질병,19,15,34
R04,2022,인천,질병,0,1,1
R04,2023,광주,질병,1,1,2
R04,2023,대구,질병,2,2,4
R04,2023,대전,질병,1,1,2
R04,2023,부산,질병,4,2,6
R04,2023,서울,질병,22,8,30
R05,2019,광주,질병,0,2,2
R05,2019,대구,질병,6,5,11
R05,2019,대전,질병,3,2,5
R05,2019,부산,질병,0,2,2
R05,2019,서울,질병,1,0,1
R05,2019,인천,질병,0,3,3
R05,2020,광주,질병,2,0,2
R05,2020,대구,질병,0,3,3
R05,2020,대전,질병,1,0,1
R05,2020,서울,질병,2,0,2
R05,2021,대전,질병,0,1,1
R05,2021,서울,질병,1,0,1
R05,2022,대구,질병,2,3,5
R05,2022,서울,질병,0,2,2
R05,2023,광주,질병,0,1,1
R05,2023,대구,질병,7,0,7
R05,2023,대전,질병,0,1,1
R05,2023,부산,질병,1,0,1
R05,2023,서울,질병,0,1,1
R06,2019,광주,질병,1,2,3
R06,2019,대구,질병,11,4,15
R06,2019,대전,질병,6,4,10
R06,2019,부산,질병,5,9,14
R06,2019,서울,질병,22,19,41
R06,2019,인천,질병,1,1,2
R06,2020,광주,질병,1,5,6
R06,2020,대구,질병,5,7,12
R06,2020,대전,질병,3,0,3
R06,2020,서울,질병,20,15,35
R06,2020,인천,질병,0,2,2
R06,2021,광주,질병,4,6,10
R06,2021,대구,질병,1,1,2
R06,2021,대전,질병,11,9,20
R06,2021,부산,질병,6,2,8
R06,2021,서울,질병,10,14,24
R06,2022,광주,질병,4,7,11
R06,2022,대구,질병,5,3,8
R06,2022,대전,질병,23,7,30
R06,2022,부산,질병,8,4,12
R06,2022,서울,질병,8,10,18
R06,2022,인천,질병,1,0,1
R06,2023,광주,질병,9,14,23
R06,2023,대구,질병,4,4,8
R06,2023,대전,질병,7,6,13
R06,2023,부산,질병,11,6,17
R06,2023,서울,질병,6,5,11
R07,2019,광주,질병,8,6,14
R07,2019,대구,질병,93,40,133
R07,2019,대전,질병,18,14,32
R07,2019,부산,질병,18,14,32
R07,2019,서울,질병,42,25,67
R07,2019,인천,질병,0,2,2
R07,2020,광주,질병,4,2,6
R07,2020,대구,질병,55,36,91
R07,2020,대전,질병,8,2,10
R07,2020,서울,질병,11,5,16
R07,2021,광주,질병,4,2,6
R07,2021,대구,질병,77,50,127
R07,2021,대전,질병,24,7,31
R07,2021,부산,질병,5,2,7
R07,2021,서울,질병,5,4,9
R07,2022,광주,질병,2,3,5
R07,2022,대구,질병,93,72,165
R07,2022,대전,질병,38,15,53
R07,2022,부산,질병,4,6,10
R07,2022,서울,질병,10,9,19
R07,2023,광주,질병,14,12,26
R07,2023,대구,질병,85,51,136
R07,2023,대전,질병,16,10,26
R07,2023,부산,질병,13,4,17
R07,2023,서울,질병,17,6,23
R09,2019,대구,질병,3,0,3
R09,2019,대전,질병,16,3,19
R09,2019,부산,질병,2,0,2
R09,2019,서울,질병,1,1,2
R09,2020,대구,질병,1,0,1
R09,2020,대전,질병,8,2,10
R09,2020,서울,질병,1,1,2
R09,2021,광주,질병,1,1,2
R09,2021,대전,질병,9,2,11
R09,2021,부산,질병,2,0,2
R09,2021,서울,질병,0,2,2
R09,2022,대전,질병,3,1,4
R09,2022,서울,질병,5,3,8
R09,2023,광주,질병,1,2,3
R09,2023,대전,질병,3,0,3
R09,2023,부산,질병,1,1,2
R09,2023,서울,질병,3,1,4
R10,2019,광주,질병,9,4,13
R10,2019,대구,질병,9,4,13
R10,2019,대전,질병,2,5,7
R10,2019,부산,질병,5,4,9
R10,2019,서울,질병,8,8,16
R10,2019,인천,질병,0,2,2
R10,2020,광주,질병,6,4,10
R10,2020,대구,질병,3,4,7
R10,2020,대전,질병,4,3,7
R10,2020,서울,질병,5,3,8
R10,2020,인천,질병,0,2,2
R10,2021,광주,질병,8,6,14
R10,2021,대구,질병,8,5,13
R10,2021,대전,질병,2,3,5
R10,2021,부산,질병,5,1,6
R10,2021,서울,질병,2,2,4
R10,2022,광주,질병,8,5,13
R10,2022,대구,질병,12,2,14
R10,2022,대전,질병,4,2,6
R10,2022,부산,질병,2,4,6
R10,2022,서울,질병,2,6,8
R10,2023,광주,질병,13,6,19
R10,2023,대구,질병,11,0,11
R10,2023,대전,질병,4,0,4
R10,2023,부산,질병,10,3,13
R10,2023,서울,질병,6,6,12
R11,2019,광주,질병,1,2,3
R11,2019,대구,질병,3,6,9
R11,2019,대전,질병,1,3,4
R11,2019,부산,질병,2,0,2
R11,2019,서울,질병,5,5,10
R11,2019,인천,질병,0,2,2
R11,2020,광주,질병,0,3,3
R11,2020,대구,질병,10,5,15
R11,2020,대전,질병,2,1,3
R11,2020,서울,질병,6,6,12
R11,2020,인천,질병,0,1,1
R11,2021,광주,질병,0,2,2
R11,2021,대구,질병,4,7,11
R11,2021,부산,질병,0,1,1
R11,2021,서울,질병,6,3,9
R11,2021,인천,질병,1,1,2
R11,2022,광주,질병,1,0,1
R11,2022,대구,질병,9,6,15
R11,2022,대전,질병,1,0,1
R11,2022,서울,질병,5,5,10
R11,2023,광주,질병,1,1,2
R11,2023,대구,질병,4,7,11
R11,2023,대전,질병,2,6,8
R11,2023,부산,질병,1,1,2
R11,2023,서울,질병,3,4,7
R12,2020,서울,질병,1,0,1
R12,2021,대구,질병,0,1,1
R12,2021,서울,질병,0,1,1
R12,2022,서울,질병,1,0,1
R12,2023,서울,질병,0,2,2
R13,2019,광주,질병,3,1,4
R13,2019,대구,질병,2,2,4
R13,2019,대전,질병,5,1,6
R13,2019,부산,질병,5,1,6
R13,2019,서울,질병,145,104,249
R13,2020,광주,질병,1,1,2
R13,2020,대구,질병,2,0,2
R13,2020,대전,질병,1,2,3
R13,2020,서울,질병,189,136,325
R13,2021,광주,질병,1,0,1
R13,2021,대구,질병,3,0,3
R13,2021,대전,질병,5,0,5
R13,2021,부산,질병,3,0,3
R13,2021,서울,질병,70,42,112
R13,2022,대구,질병,4,1,5
R13,2022,대전,질병,4,0,4
R13,2022,부산,질병,2,0,2
R13,2022,서울,질병,69,54,123
R13,2023,광주,질병,1,1,2
R13,2023,대구,질병,1,4,5
R13,2023,대전,질병,4,0,4
R13,2023,부산,질병,1,0,1
R13,2023,서울,질병,113,91,204
R14,2019,부산,질병,1,0,1
R14,2019,서울,질병,1,0,1
R14,2020,서울,질병,2,0,2
R14,2020,인천,질병,0,1,1
R14,2021,서울,질병,1,3,4
R14,2022,서울,질병,1,5,6
R14,2023,서울,질병,1,0,1
R15,2019,광주,질병,1,1,2
R15,2019,대구,질병,0,1,1
R15,2019,서울,질병,4,2,6
R15,2020,광주,질병,1,1,2
R15,2020,대전,질병,2,0,2
R15,2020,서울,질병,5,1,6
R15,2021,광주,질병,1,0,1
R15,2021,대전,질병,2,1,3
R15,2021,서울,질병,3,1,4
R15,2022,광주,질병,1,0,1
R15,2022,대전,질병,1,0,1
R15,2022,서울,질병,6,3,9
R15,2023,광주,질병,1,0,1
R15,2023,부산,질병,1,0,1
R15,2023,서울,질병,5,1,6
R16,2019,광주,질병,1,0,1
R16,2019,서울,질병,0,1,1
R16,2020,서울,질병,1,1,2
R16,2021,서울,질병,2,0,2
R16,2022,서울,질병,1,0,1
R16,2023,서울,질병,1,0,1
R17,2019,대구,질병,1,0,1
R17,2019,서울,질병,4,4,8
R17,2020,광주,질병,0,1,1
R17,2020,대구,질병,1,0,1
R17,2020,대전,질병,1,0,1
R17,2020,서울,질병,1,1,2
R17,2021,대구,질병,1,0,1
R17,2021,대전,질병,1,3,4
R17,2021,서울,질병,0,3,3
R17,2022,대전,질병,0,3,3
R17,2022,부산,질병,0,1,1
R17,2022,서울,질병,2,0,2
R17,2023,광주,질병,0,1,1
R17,2023,대구,질병,1,0,1
R17,2023,대전,질병,0,3,3
R17,2023,부산,질병,1,0,1
R17,2023,서울,질병,4,1,5
R18,2019,광주,질병,1,1,2
R18,2019,대구,질병,5,1,6
R18,2019,대전,질병,2,0,2
R18,2019,서울,질병,41,50,91
R18,2020,광주,질병,1,0,1
R18,2020,대구,질병,0,3,3
R18,2020,대전,질병,0,1,1
R18,2020,서울,질병,49,45,94
R18,2021,광주,질병,1,0,1
R18,2021,대구,질병,3,0,3
R18,2021,서울,질병,32,27,59
R18,2022,대구,질병,2,1,3
R18,2022,대전,질병,2,1,3
R18,2022,서울,질병,16,16,32
R18,2023,대구,질병,6,1,7
R18,2023,대전,질병,1,2,3
R18,2023,서울,질병,24,19,43
R19,2019,광주,질병,0,1,1
R19,2019,대구,질병,1,0,1
R19,2019,부산,질병,1,0,1
R19,2019,서울,질병,1,3,4
R19,2020,대구,질병,0,1,1
R19,2020,대전,질병,1,0,1
R19,2020,서울,질병,2,4,6
R19,2021,서울,질병,2,2,4
R19,2022,대구,질병,1,0,1
R19,2022,서울,질병,1,2,3
R19,2023,부산,질병,1,0,1
R19,2023,서울,질병,0,2,2
R20,2019,광주,질병,0,1,1
R20,2019,대구,질병,0,1,1
R20,2019,서울,질병,3,2,5
R20,2020,서울,질병,3,6,9
R20,2021,대구,질병,2,0,2
R20,2021,서울,질병,4,4,8
R20,2022,서울,질병,0,3,3
R20,2023,광주,질병,0,1,1
R20,2023,서울,질병,3,7,10
R21,2019,서울,질병,1,6,7
R21,2020,서울,질병,4,4,8
R21,2021,대구,질병,0,1,1
R21,2021,서울,질병,2,4,6
R21,2022,서울,질병,2,3,5
R21,2023,광주,질병,0,1,1
R21,2023,서울,질병,2,1,3
R22,2019,광주,질병,0,1,1
R22,2019,대전,질병,7,0,7
R22,2019,서울,질병,8,4,12
R22,2019,인천,질병,1,0,1
R22,2020,광주,질병,1,2,3
R22,2020,대전,질병,0,4,4
R22,2020,서울,질병,2,7,9
R22,2021,광주,질병,2,2,4
R22,2021,대구,질병,0,1,1
R22,2021,대전,질병,2,3,5
R22,2021,부산,질병,1,0,1
R22,2021,서울,질병,8,1,9
R22,2021,인천,질병,0,3,3
R22,2022,광주,질병,3,0,3
R22,2022,대구,질병,1,0,1
R22,2022,대전,질병,2,4,6
R22,2022,부산,질병,2,0,2
R22,2022,서울,질병,2,4,6
R22,2022,인천,질병,0,1,1
R22,2023,광주,질병,1,0,1
R22,2023,대전,질병,8,8,16
R22,2023,서울,질병,3,8,11
R23,2019,대전,질병,0,1,1
R23,2019,부산,질병,1,0,1
R23,2019,서울,질병,12,5,17
R23,2020,서울,질병,12,12,24
R23,2021,서울,질병,9,8,17
R23,2022,서울,질병,13,3,16
R23,2023,서울,질병,10,4,14
R25,2019,광주,질병,2,2,4
R25,2019,대전,질병,2,0,2
R25,2019,부산,질병,2,1,3
R25,2019,서울,질병,13,6,19
R25,2020,광주,질병,5,6,11
R25,2020,대구,질병,1,0,1
R25,2020,대전,질병,5,0,5
R25,2020,서울,질병,9,5,14
R25,2021,광주,질병,4,6,10
R25,2021,대전,질병,1,0,1
R25,2021,부산,질병,3,0,3
R25,2021,서울,질병,8,3,11
R25,2022,광주,질병,4,0,4
R25,2022,대전,질병,2,0,2
R25,2022,부산,질병,1,1,2
R25,2022,서울,질병,10,5,15
R25,2023,광주,질병,5,2,7
R25,2023,대전,질병,1,0,1
R25,2023,서울,질병,13,1,14
R25,2023,인천,질병,2,0,2
R26,2019,대구,질병,3,0,3
R26,2019,대전,질병,6,1,7
R26,2019,서울,질병,120,81,201
R26,2019,인천,질병,0,1,1
R26,2020,광주,질병,0,1,1
R26,2020,대구,질병,7,0,7
R26,2020,대전,질병,0,1,1
R26,2020,서울,질병,89,43,132
R26,2020,인천,질병,2,1,3
R26,2021,광주,질병,3,1,4
R26,2021,대구,질병,12,1,13
R26,2021,서울,질병,30,18,48
R26,2021,인천,질병,2,1,3
R26,2022,광주,질병,2,0,2
R26,2022,대구,질병,4,1,5
R26,2022,대전,질병,0,1,1
R26,2022,서울,질병,33,19,52
R26,2022,인천,질병,1,2,3
R26,2023,대구,질병,12,2,14
R26,2023,대전,질병,1,2,3
R26,2023,부산,질병,3,1,4
R26,2023,서울,질병,104,59,163
R27,2019,광주,질병,0,1,1
R27,2019,서울,질병,7,3,10
R27,2020,광주,질병,0,1,1
R27,2020,서울,질병,5,1,6
R27,2021,서울,질병,0,1,1
R27,2022,광주,질병,0,1,1
R27,2023,광주,질병,1,1,2
R29,2019,서울,질병,1,1,2
R29,2020,서울,질병,1,0,1
R29,2021,서울,질병,5,0,5
R29,2022,서울,질병,2,3,5
R29,2023,서울,질병,2,2,4
R30,2019,대구,질병,1,0,1
R30,2019,서울,질병,2,0,2
R30,2020,서울,질병,2,2,4
R30,2021,대전,질병,0,1,1
R30,2021,서울,질병,3,2,5
R30,2022,광주,질병,0,1,1
R30,2022,서울,질병,4,8,12
R30,2023,광주,질병,0,1,1
R30,2023,서울,질병,3,2,5
R31,2019,광주,질병,1,4,5
R31,2019,대구,질병,9,5,14
R31,2019,대전,질병,8,5,13
R31,2019,부산,질병,6,3,9
R31,2019,서울,질병,18,25,43
R31,2019,인천,질병,1,1,2
R31,2020,광주,질병,7,8,15
R31,2020,대구,질병,6,1,7
R31,2020,대전,질병,9,8,17
R31,2020,서울,질병,29,22,51
R31,2020,인천,질병,0,1,1
R31,2021,광주,질병,5,2,7
R31,2021,대구,질병,1,3,4
R31,2021,대전,질병,8,5,13
R31,2021,부산,질병,5,0,5
R31,2021,서울,질병,26,30,56
R31,2021,인천,질병,0,3,3
R31,2022,광주,질병,0,3,3
R31,2022,대구,질병,6,0,6
R31,2022,대전,질병,2,5,7
R31,2022,부산,질병,2,1,3
R31,2022,서울,질병,28,22,50
R31,2023,광주,질병,3,4,7
R31,2023,대구,질병,11,7,18
R31,2023,대전,질병,3,2,5
R31,2023,부산,질병,1,1,2
R31,2023,서울,질병,25,31,56
R31,2023,인천,질병,0,2,2
R32,2019,대전,질병,2,0,2
R32,2019,부산,질병,1,0,1
R32,2019,서울,질병,7,7,14
R32,2020,대구,질병,1,0,1
R32,2020,대전,질병,5,0,5
R32,2020,서울,질병,8,9,17
R32,2021,대전,질병,1,0,1
R32,2021,서울,질병,8,9,17
R32,2022,대구,질병,1,0,1
R32,2022,대전,질병,0,1,1
R32,2022,서울,질병,3,6,9
R32,2023,서울,질병,9,12,21
R33,2019,광주,질병,0,1,1
R33,2019,대구,질병,3,4,7
R33,2019,대전,질병,1,1,2
R33,2019,부산,질병,3,1,4
R33,2019,서울,질병,15,14,29
R33,2020,광주,질병,0,1,1
R33,2020,대구,질병,1,4,5
R33,2020,대전,질병,0,1,1
R33,2020,서울,질병,21,12,33
R33,2021,대구,질병,2,1,3
R33,2021,부산,질병,3,1,4
R33,2021,서울,질병,20,8,28
R33,2022,대구,질병,3,0,3
R33,2022,대전,질병,1,0,1
R33,2022,서울,질병,16,11,27
R33,2023,대구,질병,4,1,5
R33,2023,대전,질병,1,1,2
R33,2023,부산,질병,2,0,2
R33,2023,서울,질병,9,12,21
R34,2019,서울,질병,0,1,1
R34,2020,서울,질병,1,2,3
R34,2021,서울,질병,1,2,3
R34,2022,서울,질병,5,3,8
R34,2023,서울,질병,2,2,4
R35,2019,대전,질병,8,3,11
R35,2019,부산,질병,0,1,1
R35,2019,서울,질병,20,27,47
R35,2020,대구,질병,0,2,2
R35,2020,대전,질병,7,2,9
R35,2020,서울,질병,12,38,50
R35,2021,대전,질병,11,5,16
R35,2021,서울,질병,16,26,42
R35,2022,대구,질병,1,0,1
R35,2022,대전,질병,2,0,2
R35,2022,서울,질병,24,38,62
R35,2023,대구,질병,0,1,1
R35,2023,대전,질병,4,0,4
R35,2023,부산,질병,1,0,1
R35,2023,서울,질병,42,31,73
R36,2019,대전,질병,1,0,1
R36,2021,대전,질병,1,0,1
R36,2022,대전,질병,1,0,1
R36,2023,대전,질병,1,0,1
R39,2019,대전,질병,2,1,3
R39,2019,부산,질병,1,0,1
R39,2019,서울,질병,22,34,56
R39,2020,광주,질병,0,1,1
R39,2020,대전,질병,1,0,1
R39,2020,서울,질병,16,18,34
R39,2021,광주,질병,0,1,1
R39,2021,대전,질병,1,0,1
R39,2021,서울,질병,24,22,46
R39,2022,대전,질병,0,1,1
R39,2022,서울,질병,38,42,80
R39,2023,서울,질병,37,48,85
R40,2019,광주,질병,0,2,2
R40,2019,부산,질병,0,1,1
R40,2019,서울,질병,1,0,1
R40,2020,광주,질병,1,2,3
R40,2020,서울,질병,1,0,1
R40,2022,서울,질병,0,1,1
R40,2023,서울,질병,1,1,2
R41,2019,광주,질병,3,2,5
R41,2019,대구,질병,1,2,3
R41,2019,서울,질병,14,8,22
R41,2020,광주,질병,8,10,18
R41,2020,서울,질병,5,8,13
R41,2021,광주,질병,6,11,17
R41,2021,대구,질병,1,1,2
R41,2021,서울,질병,4,4,8
R41,2022,광주,질병,8,8,16
R41,2022,대구,질병,1,0,1
R41,2022,서울,질병,5,3,8
R41,2023,광주,질병,10,1,11
R41,2023,서울,질병,5,4,9
R42,2019,광주,질병,16,35,51
R42,2019,대구,질병,11,8,19
R42,2019,대전,질병,41,19,60
R42,2019,부산,질병,10,7,17
R42,2019,서울,질병,26,21,47
R42,2019,인천,질병,12,10,22
R42,2020,광주,질병,45,63,108
R42,2020,대구,질병,16,4,20
R42,2020,대전,질병,33,14,47
R42,2020,서울,질병,18,28,46
R42,2020,인천,질병,7,10,17
R42,2021,광주,질병,66,63,129
R42,2021,대구,질병,6,1,7
R42,2021,대전,질병,51,18,69
R42,2021,부산,질병,13,4,17
R42,2021,서울,질병,21,21,42
R42,2021,인천,질병,2,5,7
R42,2022,광주,질병,34,43,77
R42,2022,대구,질병,4,3,7
R42,2022,대전,질병,23,17,40
R42,2022,부산,질병,12,3,15
R42,2022,서울,질병,14,15,29
R42,2022,인천,질병,2,2,4
R42,2023,광주,질병,65,52,117
R42,2023,대구,질병,5,6,11
R42,2023,대전,질병,35,3,38
R42,2023,부산,질병,9,3,12
R42,2023,서울,질병,20,18,38
R42,2023,인천,질병,2,6,8
R43,2019,서울,질병,1,1,2
R43,2020,서울,질병,1,1,2
R43,2021,서울,질병,0,1,1
R43,2022,서울,질병,1,0,1
R43,2023,서울,질병,1,0,1
R44,2019,서울,질병,3,1,4
R44,2020,광주,질병,1,2,3
R44,2020,대구,질병,0,1,1
R44,2020,서울,질병,1,2,3
R44,2020,인천,질병,1,0,1
R44,2021,서울,질병,1,1,2
R44,2022,광주,질병,0,1,1
R44,2022,서울,질병,1,1,2
R44,2022,인천,질병,1,0,1
R44,2023,광주,질병,0,1,1
R44,2023,서울,질병,2,1,3
R45,2019,광주,질병,0,1,1
R45,2020,서울,질병,1,0,1
R45,2022,광주,질병,1,0,1
R47,2019,대구,질병,1,0,1
R47,2019,대전,질병,3,0,3
R47,2019,서울,질병,112,63,175
R47,2020,광주,질병,1,6,7
R47,2020,대구,질병,2,0,2
R47,2020,대전,질병,4,0,4
R47,2020,서울,질병,106,66,172
R47,2021,광주,질병,2,1,3
R47,2021,대전,질병,6,0,6
R47,2021,서울,질병,28,15,43
R47,2022,광주,질병,1,2,3
R47,2022,대구,질병,1,1,2
R47,2022,대전,질병,3,0,3
R47,2022,서울,질병,18,12,30
R47,2023,대전,질병,3,0,3
R47,2023,부산,질병,1,0,1
R47,2023,서울,질병,38,26,64
R48,2022,서울,질병,0,1,1
R48,2023,인천,질병,0,1,1
R49,2019,서울,질병,2,1,3
R50,2019,광주,질병,4,30,34
R50,2019,대구,질병,10,14,24
R50,2019,대전,질병,12,10,22
R50,2019,부산,질병,6,5,11
R50,2019,서울,질병,14,11,25
R50,2019,인천,질병,0,1,1
R50,2020,광주,질병,2,21,23
R50,2020,대구,질병,15,4,19
R50,2020,대전,질병,12,8,20
R50,2020,서울,질병,17,19,36
R50,2020,인천,질병,0,2,2
R50,2021,광주,질병,14,13,27
R50,2021,대구,질병,8,7,15
R50,2021,대전,질병,2,1,3
R50,2021,부산,질병,7,2,9
R50,2021,서울,질병,18,16,34
R50,2021,인천,질병,1,1,2
R50,2022,광주,질병,6,8,14
R50,2022,대구,질병,12,7,19
R50,2022,대전,질병,9,3,12
R50,2022,부산,질병,1,1,2
R50,2022,서울,질병,11,14,25
R50,2022,인천,질병,0,1,1
R50,2023,광주,질병,7,17,24
R50,2023,대구,질병,12,3,15
R50,2023,대전,질병,9,7,16
R50,2023,부산,질병,4,1,5
R50,2023,서울,질병,14,9,23
R50,2023,인천,질병,1,0,1
R51,2019,광주,질병,10,65,75
R51,2019,대구,질병,9,4,13
R51,2019,대전,질병,14,8,22
R51,2019,부산,질병,7,1,8
R51,2019,서울,질병,24,20,44
R51,2019,인천,질병,4,10,14
R51,2020,광주,질병,15,68,83
R51,2020,대구,질병,6,3,9
R51,2020,대전,질병,7,4,11
R51,2020,서울,질병,16,20,36
R51,2020,인천,질병,2,1,3
R51,2021,광주,질병,23,44,67
R51,2021,대구,질병,7,2,9
R51,2021,대전,질병,5,9,14
R51,2021,부산,질병,5,0,5
R51,2021,서울,질병,23,15,38
R51,2022,광주,질병,13,37,50
R51,2022,대구,질병,1,2,3
R51,2022,대전,질병,4,4,8
R51,2022,부산,질병,1,1,2
R51,2022,서울,질병,11,15,26
R51,2023,광주,질병,7,16,23
R51,2023,대전,질병,11,6,17
R51,2023,부산,질병,2,1,3
R51,2023,서울,질병,22,18,40
R52,2019,광주,질병,0,1,1
R52,2019,대구,질병,3,2,5
R52,2019,대전,질병,8,3,11
R52,2019,부산,질병,4,1,5
R52,2019,서울,질병,57,14,71
R52,2019,인천,질병,0,1,1
R52,2020,광주,질병,2,1,3
R52,2020,대구,질병,1,1,2
R52,2020,대전,질병,6,0,6
R52,2020,서울,질병,28,12,40
R52,2020,인천,질병,1,2,3
R52,2021,광주,질병,2,1,3
R52,2021,대구,질병,2,0,2
R52,2021,대전,질병,7,0,7
R52,2021,서울,질병,10,3,13
R52,2021,인천,질병,2,1,3
R52,2022,광주,질병,3,3,6
R52,2022,대구,질병,1,2,3
R52,2022,대전,질병,3,2,5
R52,2022,부산,질병,1,0,1
R52,2022,서울,질병,7,14,21
R52,2022,인천,질병,1,0,1
R52,2023,광주,질병,1,1,2
R52,2023,대구,질병,2,0,2
R52,2023,대전,질병,5,1,6
R52,2023,부산,질병,1,4,5
R52,2023,서울,질병,7,14,21
R52,2023,인천,질병,1,0,1
R53,2019,광주,질병,9,5,14
R53,2019,대구,질병,38,8,46
R53,2019,대전,질병,19,10,29
R53,2019,부산,질병,6,1,7
R53,2019,서울,질병,9,10,19
R53,2019,인천,질병,0,4,4
R53,2020,광주,질병,8,8,16
R53,2020,대구,질병,37,10,47
R53,2020,대전,질병,10,5,15
R53,2020,서울,질병,13,6,19
R53,2020,인천,질병,1,3,4
R53,2021,광주,질병,9,12,21
R53,2021,대구,질병,4,3,7
R53,2021,대전,질병,11,10,21
R53,2021,부산,질병,5,1,6
R53,2021,서울,질병,9,8,17
R53,2021,인천,질병,0,1,1
R53,2022,광주,질병,10,7,17
R53,2022,대구,질병,18,18,36
R53,2022,대전,질병,14,9,23
R53,2022,부산,질병,3,1,4
R53,2022,서울,질병,10,10,20
R53,2022,인천,질병,1,1,2
R53,2023,광주,질병,22,11,33
R53,2023,대구,질병,26,9,35
R53,2023,대전,질병,11,3,14
R53,2023,부산,질병,13,2,15
R53,2023,서울,질병,7,5,12
R53,2023,인천,질병,0,1,1
R54,2020,대구,질병,0,1,1
R54,2021,광주,질병,1,0,1
R54,2023,서울,질병,0,1,1
R54,2023,인천,질병,0,1,1
R55,2019,광주,질병,11,6,17
R55,2019,대구,질병,22,10,32
R55,2019,대전,질병,6,1,7
R55,2019,부산,질병,14,5,19
R55,2019,서울,질병,16,23,39
R55,2019,인천,질병,0,3,3
R55,2020,광주,질병,15,16,31
R55,2020,대구,질병,9,4,13
R55,2020,대전,질병,3,1,4
R55,2020,서울,질병,18,8,26
R55,2021,광주,질병,12,13,25
R55,2021,대구,질병,5,2,7
R55,2021,대전,질병,3,2,5
R55,2021,부산,질병,8,2,10
R55,2021,서울,질병,11,13,24
R55,2022,광주,질병,13,8,21
R55,2022,대구,질병,9,4,13
R55,2022,대전,질병,1,0,1
R55,2022,부산,질병,2,4,6
R55,2022,서울,질병,9,11,20
R55,2023,광주,질병,22,11,33
R55,2023,대구,질병,5,9,14
R55,2023,대전,질병,5,1,6
R55,2023,부산,질병,5,4,9
R55,2023,서울,질병,13,12,25
R55,2023,인천,질병,1,2,3
R56,2019,광주,질병,0,11,11
R56,2019,대구,질병,1,3,4
R56,2019,대전,질병,7,1,8
R56,2019,부산,질병,6,0,6
R56,2019,서울,질병,37,28,65
R56,2020,광주,질병,5,3,8
R56,2020,대구,질병,1,3,4
R56,2020,대전,질병,8,8,16
R56,2020,서울,질병,23,28,51
R56,2021,광주,질병,3,7,10
R56,2021,대구,질병,0,1,1
R56,2021,대전,질병,4,0,4
R56,2021,부산,질병,2,1,3
R56,2021,서울,질병,9,8,17
R56,2022,광주,질병,3,5,8
R56,2022,대구,질병,3,1,4
R56,2022,대전,질병,3,1,4
R56,2022,부산,질병,1,1,2
R56,2022,서울,질병,13,10,23
R56,2023,광주,질병,2,4,6
R56,2023,대구,질병,1,1,2
R56,2023,대전,질병,4,0,4
R56,2023,부산,질병,2,1,3
R56,2023,서울,질병,12,5,17
R57,2019,광주,질병,1,1,2
R57,2019,대구,질병,3,3,6
R57,2019,대전,질병,7,3,10
R57,2019,서울,질병,41,45,86
R57,2020,광주,질병,1,1,2
R57,2020,대구,질병,6,1,7
R57,2020,대전,질병,6,6,12
R57,2020,서울,질병,75,44,119
R57,2021,광주,질병,2,0,2
R57,2021,대구,질병,5,3,8
R57,2021,대전,질병,1,4,5
R57,2021,부산,질병,1,1,2
R57,2021,서울,질병,36,38,74
R57,2021,인천,질병,0,1,1
R57,2022,광주,질병,0,1,1
R57,2022,대구,질병,4,0,4
R57,2022,대전,질병,5,5,10
R57,2022,서울,질병,70,55,125
R57,2023,대구,질병,8,2,10
R57,2023,대전,질병,6,4,10
R57,2023,부산,질병,2,0,2
R57,2023,서울,질병,80,84,164
R58,2019,광주,질병,1,0,1
R58,2020,서울,질병,3,1,4
R58,2021,대구,질병,1,0,1
R58,2021,부산,질병,1,0,1
R58,2021,서울,질병,2,0,2
R58,2022,서울,질병,0,2,2
R58,2023,대구,질병,2,0,2
R58,2023,부산,질병,0,1,1
R58,2023,서울,질병,0,1,1
R59,2019,광주,질병,2,2,4
R59,2019,대구,질병,2,0,2
R59,2019,서울,질병,5,3,8
R59,2020,광주,질병,1,1,2
R59,2020,대구,질병,2,1,3
R59,2020,서울,질병,11,10,21
R59,2021,광주,질병,2,1,3
R59,2021,대전,질병,2,1,3
R59,2021,서울,질병,12,3,15
R59,2022,광주,질병,0,1,1
R59,2022,대구,질병,1,0,1
R59,2022,대전,질병,0,1,1
R59,2022,부산,질병,0,1,1
R59,2022,서울,질병,9,5,14
R59,2023,광주,질병,2,0,2
R59,2023,대구,질병,2,0,2
R59,2023,대전,질병,1,0,1
R59,2023,서울,질병,13,3,16
R60,2019,광주,질병,2,2,4
R60,2019,대구,질병,11,3,14
R60,2019,대전,질병,6,7,13
R60,2019,부산,질병,11,9,20
R60,2019,서울,질병,11,11,22
R60,2020,광주,질병,7,1,8
R60,2020,대구,질병,6,6,12
R60,2020,대전,질병,2,0,2
R60,2020,서울,질병,21,8,29
R60,2021,광주,질병,5,3,8
R60,2021,대구,질병,3,4,7
R60,2021,대전,질병,1,2,3
R60,2021,부산,질병,4,9,13
R60,2021,서울,질병,10,8,18
R60,2021,인천,질병,1,1,2
R60,2022,광주,질병,2,2,4
R60,2022,대구,질병,6,6,12
R60,2022,대전,질병,4,1,5
R60,2022,부산,질병,6,3,9
R60,2022,서울,질병,8,16,24
R60,2023,광주,질병,7,4,11
R60,2023,대구,질병,6,4,10
R60,2023,대전,질병,1,1,2
R60,2023,부산,질병,3,8,11
R60,2023,서울,질병,4,2,6
R61,2020,서울,질병,2,0,2
R61,2021,서울,질병,1,0,1
R61,2022,서울,질병,2,0,2
R63,2019,광주,질병,1,0,1
R63,2019,대구,질병,9,1,10
R63,2019,대전,질병,6,2,8
R63,2019,부산,질병,0,3,3
R63,2019,서울,질병,5,4,9
R63,2019,인천,질병,4,1,5
R63,2020,광주,질병,2,0,2
R63,2020,대구,질병,4,0,4
R63,2020,서울,질병,6,4,10
R63,2020,인천,질병,1,0,1
R63,2021,대구,질병,1,0,1
R63,2021,대전,질병,3,2,5
R63,2021,부산,질병,4,1,5
R63,2021,서울,질병,3,1,4
R63,2021,인천,질병,4,3,7
R63,2022,대구,질병,6,5,11
R63,2022,대전,질병,1,0,1
R63,2022,부산,질병,0,1,1
R63,2022,서울,질병,7,3,10
R63,2022,인천,질병,0,2,2
R63,2023,광주,질병,1,0,1
R63,2023,대구,질병,3,7,10
R63,2023,대전,질병,1,0,1
R63,2023,부산,질병,0,2,2
R63,2023,서울,질병,12,10,22
R64,2019,서울,질병,1,0,1
R64,2021,부산,질병,2,0,2
R64,2021,서울,질병,0,1,1
R64,2022,대구,질병,1,0,1
R64,2022,서울,질병,0,1,1
R65,2019,대전,질병,1,2,3
R65,2019,서울,질병,1,0,1
R65,2020,대전,질병,1,0,1
R65,2021,대전,질병,0,1,1
R65,2021,부산,질병,1,0,1
R65,2021,서울,질병,1,0,1
R65,2022,대구,질병,2,0,2
R65,2022,대전,질병,1,0,1
R65,2023,대전,질병,1,0,1
R65,2023,서울,질병,1,0,1
R68,2019,대구,질병,0,1,1
R68,2019,대전,질병,1,0,1
R68,2020,대구,질병,1,1,2
R68,2020,대전,질병,1,0,1
R68,2020,서울,질병,0,2,2
R68,2021,대전,질병,1,0,1
R68,2021,서울,질병,0,1,1
R68,2022,대구,질병,1,0,1
R68,2022,서울,질병,3,3,6
R68,2023,대구,질병,2,1,3
R68,2023,부산,질병,1,0,1
R68,2023,서울,질병,2,0,2
R69,2019,부산,질병,8,3,11
R69,2019,서울,질병,0,1,1
R69,2020,서울,질병,1,0,1
R69,2021,부산,질병,7,0,7
R69,2022,부산,질병,14,0,14
R69,2023,부산,질병,4,0,4
R71,2019,서울,질병,0,1,1
R72,2021,부산,질병,1,0,1
R72,2021,서울,질병,1,0,1
R73,2019,광주,질병,0,1,1
R73,2019,대구,질병,1,3,4
R73,2019,대전,질병,4,0,4
R73,2019,서울,질병,3,4,7
R73,2020,대구,질병,2,0,2
R73,2020,대전,질병,3,0,3
R73,2020,서울,질병,7,8,15
R73,2020,인천,질병,1,0,1
R73,2021,대구,질병,0,1,1
R73,2021,대전,질병,1,1,2
R73,2021,부산,질병,5,2,7
R73,2021,서울,질병,4,6,10
R73,2022,광주,질병,2,0,2
R73,2022,대구,질병,1,0,1
R73,2022,부산,질병,2,0,2
R73,2022,서울,질병,13,9,22
R73,2023,광주,질병,0,1,1
R73,2023,부산,질병,4,0,4
R73,2023,서울,질병,10,11,21
R74,2020,대전,질병,1,0,1
R74,2020,서울,질병,0,1,1
R74,2021,광주,질병,2,1,3
R74,2022,광주,질병,1,0,1
R74,2022,대전,질병,0,1,1
R74,2023,광주,질병,3,0,3
R74,2023,대전,질병,1,1,2
R75,2020,서울,질병,1,1,2
R75,2021,서울,질병,0,1,1
R75,2022,서울,질병,0,1,1
R76,2019,서울,질병,3,3,6
R76,2020,서울,질병,2,1,3
R76,2022,서울,질병,2,1,3
R76,2023,서울,질병,2,1,3
R77,2020,서울,질병,1,0,1
R79,2019,서울,질병,1,0,1
R79,2020,대구,질병,2,0,2
R79,2020,서울,질병,1,2,3
R79,2021,대구,질병,1,0,1
R79,2022,서울,질병,2,2,4
R80,2019,서울,질병,4,1,5
R80,2020,광주,질병,2,2,4
R80,2020,서울,질병,5,7,12
R80,2021,광주,질병,0,1,1
R80,2021,대구,질병,1,0,1
R80,2021,서울,질병,0,2,2
R80,2022,서울,질병,3,4,7
R80,2023,광주,질병,2,0,2
R80,2023,대구,질병,1,0,1
R80,2023,대전,질병,0,1,1
R80,2023,서울,질병,2,1,3
R82,2022,대전,질병,0,1,1
R82,2023,서울,질병,1,0,1
R84,2023,서울,질병,1,0,1
R85,2022,광주,질병,1,0,1
R87,2019,서울,질병,0,5,5
R87,2020,서울,질병,0,2,2
R87,2021,서울,질병,0,1,1
R87,2022,서울,질병,0,3,3
R87,2023,서울,질병,0,2,2
R89,2019,서울,질병,0,1,1
R89,2020,대전,질병,1,0,1
R89,2020,서울,질병,1,1,2
R89,2023,서울,질병,0,1,1
R90,2019,서울,질병,2,0,2
R90,2020,서울,질병,1,0,1
R90,2021,서울,질병,0,1,1
R90,2022,서울,질병,1,1,2
R90,2023,서울,질병,0,4,4
R91,2019,대구,질병,1,3,4
R91,2019,부산,질병,1,2,3
R91,2019,서울,질병,12,7,19
R91,2020,대구,질병,5,2,7
R91,2020,서울,질병,7,6,13
R91,2021,부산,질병,1,0,1
R91,2021,서울,질병,6,3,9
R91,2022,서울,질병,8,10,18
R91,2023,광주,질병,0,1,1
R91,2023,대구,질병,0,1,1
R91,2023,부산,질병,1,1,2
R91,2023,서울,질병,32,18,50
R92,2019,광주,질병,2,0,2
R92,2020,광주,질병,0,1,1
R92,2023,서울,질병,0,3,3
R93,2019,부산,질병,1,0,1
R93,2019,서울,질병,6,5,11
R93,2020,서울,질병,4,5,9
R93,2021,부산,질병,1,0,1
R93,2021,서울,질병,3,3,6
R93,2022,대구,질병,1,0,1
R93,2022,부산,질병,3,0,3
R93,2022,서울,질병,10,6,16
R93,2023,부산,질병,3,0,3
R93,2023,서울,질병,19,13,32
R94,2019,광주,질병,0,1,1
R94,2019,대구,질병,0,1,1
R94,2019,대전,질병,1,0,1
R94,2019,부산,질병,2,0,2
R94,2019,서울,질병,15,20,35
R94,2020,대구,질병,3,6,9
R94,2020,서울,질병,10,11,21
R94,2021,대구,질병,0,1,1
R94,2021,부산,질병,2,0,2
R94,2021,서울,질병,12,12,24
R94,2022,광주,질병,0,4,4
R94,2022,대구,질병,2,0,2
R94,2022,부산,질병,1,0,1
R94,2022,서울,질병,9,10,19
R94,2023,광주,질병,1,6,7
R94,2023,대구,질병,1,0,1
R94,2023,부산,질병,1,1,2
R94,2023,서울,질병,28,28,56
S00,2019,광주,질병,0,1,1
S00,2019,대전,질병,4,3,7
S00,2019,부산,질병,0,1,1
S00,2019,서울,질병,9,4,13
S00,2020,광주,질병,0,2,2
S00,2020,대전,질병,2,3,5
S00,2020,서울,질병,5,6,11
S00,2021,대구,질병,0,1,1
S00,2021,대전,질병,1,2,3
S00,2021,서울,질병,4,2,6
S00,2022,대전,질병,1,3,4
S00,2022,서울,질병,5,3,8
S00,2023,대구,질병,1,1,2
S00,2023,대전,질병,0,3,3
S00,2023,서울,질병,14,9,23
S01,2019,광주,질병,0,2,2
S01,2019,대구,질병,4,3,7
S01,2019,대전,질병,1,4,5
S01,2019,부산,질병,6,0,6
S01,2019,서울,질병,15,11,26
S01,2019,인천,질병,2,0,2
S01,2020,광주,질병,2,2,4
S01,2020,대구,질병,4,2,6
S01,2020,대전,질병,3,1,4
S01,2020,서울,질병,8,8,16
S01,2021,광주,질병,0,1,1
S01,2021,대구,질병,1,1,2
S01,2021,대전,질병,3,0,3
S01,2021,부산,질병,5,0,5
S01,2021,서울,질병,10,4,14
S01,2021,인천,질병,1,0,1
S01,2022,대구,질병,4,0,4
S01,2022,대전,질병,5,0,5
S01,2022,부산,질병,3,0,3
S01,2022,서울,질병,1,7,8
S01,2022,인천,질병,0,1,1
S01,2023,광주,질병,2,0,2
S01,2023,대구,질병,1,2,3
S01,2023,대전,질병,1,1,2
S01,2023,부산,질병,4,1,5
S01,2023,서울,질병,12,10,22
S02,2019,광주,질병,1,1,2
S02,2019,대구,질병,0,2,2
S02,2019,대전,질병,3,2,5
S02,2019,부산,질병,1,3,4
S02,2019,서울,질병,18,18,36
S02,2020,광주,질병,0,1,1
S02,2020,대구,질병,2,0,2
S02,2020,대전,질병,2,1,3
S02,2020,서울,질병,28,18,46
S02,2020,인천,질병,1,1,2
S02,2021,광주,질병,1,0,1
S02,2021,대구,질병,0,1,1
S02,2021,대전,질병,2,0,2
S02,2021,부산,질병,2,1,3
S02,2021,서울,질병,23,17,40
S02,2022,광주,질병,1,0,1
S02,2022,대구,질병,1,0,1
S02,2022,부산,질병,1,0,1
S02,2022,서울,질병,22,25,47
S02,2023,광주,질병,0,2,2
S02,2023,대구,질병,1,0,1
S02,2023,대전,질병,0,2,2
S02,2023,부산,질병,1,0,1
S02,2023,서울,질병,18,17,35
S03,2019,광주,질병,0,1,1
S03,2021,서울,질병,1,0,1
S03,2022,서울,질병,1,2,3
S03,2023,서울,질병,1,0,1
S04,2020,광주,질병,0,1,1
S04,2021,서울,질병,1,0,1
S05,2019,서울,질병,3,6,9
S05,2020,대구,질병,0,1,1
S05,2020,서울,질병,5,5,10
S05,2021,서울,질병,6,3,9
S05,2022,서울,질병,2,1,3
S05,2023,서울,질병,1,1,2
S06,2019,광주,질병,21,46,67
S06,2019,대구,질병,16,9,25
S06,2019,대전,질병,31,32,63
S06,2019,부산,질병,29,13,42
S06,2019,서울,질병,65,61,126
S06,2019,인천,질병,1,1,2
S06,2020,광주,질병,33,40,73
S06,2020,대구,질병,17,8,25
S06,2020,대전,질병,27,21,48
S06,2020,서울,질병,66,80,146
S06,2020,인천,질병,3,4,7
S06,2021,광주,질병,22,31,53
S06,2021,대구,질병,19,12,31
S06,2021,대전,질병,19,18,37
S06,2021,부산,질병,32,19,51
S06,2021,서울,질병,60,51,111
S06,2021,인천,질병,1,3,4
S06,2022,광주,질병,21,7,28
S06,2022,대구,질병,11,5,16
S06,2022,대전,질병,33,16,49
S06,2022,부산,질병,33,14,47
S06,2022,서울,질병,72,60,132
S06,2022,인천,질병,0,2,2
S06,2023,광주,질병,27,11,38
S06,2023,대구,질병,10,8,18
S06,2023,대전,질병,26,20,46
S06,2023,부산,질병,28,6,34
S06,2023,서울,질병,71,69,140
S06,2023,인천,질병,1,1,2
S07,2019,대전,질병,1,0,1
S09,2019,서울,질병,1,1,2
S09,2020,광주,질병,0,1,1
S09,2020,대전,질병,2,0,2
S09,2020,서울,질병,2,1,3
S09,2021,대구,질병,0,1,1
S09,2021,서울,질병,1,0,1
S09,2022,대구,질병,1,0,1
S09,2022,서울,질병,1,0,1
S09,2023,광주,질병,1,1,2
S09,2023,대구,질병,1,0,1
S09,2023,서울,질병,1,0,1
S10,2022,서울,질병,2,1,3
S11,2021,서울,질병,1,0,1
S12,2019,광주,질병,0,4,4
S12,2019,대구,질병,1,0,1
S12,2019,대전,질병,2,0,2
S12,2019,부산,질병,1,1,2
S12,2019,서울,질병,1,4,5
S12,2020,대구,질병,1,0,1
S12,2020,서울,질병,1,5,6
S12,2021,대구,질병,0,2,2
S12,2021,대전,질병,1,0,1
S12,2021,부산,질병,3,1,4
S12,2021,서울,질병,1,1,2
S12,2022,대구,질병,1,0,1
S12,2022,대전,질병,1,0,1
S12,2023,광주,질병,0,2,2
S12,2023,대구,질병,1,1,2
S12,2023,부산,질병,4,0,4
S12,2023,서울,질병,0,2,2
S13,2019,광주,질병,2,12,14
S13,2019,대구,질병,0,1,1
S13,2019,대전,질병,7,10,17
S13,2019,부산,질병,4,2,6
S13,2019,서울,질병,2,3,5
S13,2020,광주,질병,0,9,9
S13,2020,대구,질병,0,2,2
S13,2020,대전,질병,8,10,18
S13,2020,서울,질병,1,4,5
S13,2021,광주,질병,2,4,6
S13,2021,대구,질병,0,2,2
S13,2021,대전,질병,3,4,7
S13,2021,부산,질병,7,1,8
S13,2021,서울,질병,0,1,1
S13,2022,대구,질병,4,0,4
S13,2022,대전,질병,0,2,2
S13,2022,부산,질병,10,5,15
S13,2022,서울,질병,0,1,1
S13,2023,광주,질병,1,2,3
S13,2023,대전,질병,7,4,11
S13,2023,부산,질병,4,0,4
S13,2023,서울,질병,1,0,1
S13,2023,인천,질병,0,1,1
S14,2019,광주,질병,6,3,9
S14,2019,대구,질병,0,1,1
S14,2019,대전,질병,4,1,5
S14,2019,부산,질병,1,0,1
S14,2019,서울,질병,2,1,3
S14,2020,광주,질병,3,2,5
S14,2020,대전,질병,3,1,4
S14,2020,서울,질병,0,1,1
S14,2021,광주,질병,6,2,8
S14,2021,대전,질병,3,1,4
S14,2021,서울,질병,1,0,1
S14,2022,광주,질병,6,2,8
S14,2022,대전,질병,0,1,1
S14,2022,서울,질병,0,1,1
S14,2023,광주,질병,6,5,11
S14,2023,대전,질병,1,2,3
S14,2023,부산,질병,1,0,1
S14,2023,서울,질병,2,5,7
S19,2021,서울,질병,1,0,1
S19,2022,서울,질병,1,0,1
S20,2019,광주,질병,1,2,3
S20,2019,대구,질병,1,1,2
S20,2019,대전,질병,1,1,2
S20,2019,부산,질병,1,1,2
S20,2019,서울,질병,0,2,2
S20,2019,인천,질병,0,1,1
S20,2020,광주,질병,3,6,9
S20,2020,서울,질병,3,1,4
S20,2021,대구,질병,1,0,1
S20,2021,대전,질병,0,1,1
S20,2021,서울,질병,0,1,1
S20,2022,대전,질병,1,0,1
S20,2022,부산,질병,0,1,1
S20,2022,서울,질병,0,1,1
S20,2023,광주,질병,0,1,1
S20,2023,서울,질병,1,1,2
S22,2019,광주,질병,26,46,72
S22,2019,대구,질병,23,53,76
S22,2019,대전,질병,32,51,83
S22,2019,부산,질병,36,26,62
S22,2019,서울,질병,29,55,84
S22,2019,인천,질병,3,5,8
S22,2020,광주,질병,28,56,84
S22,2020,대구,질병,34,32,66
S22,2020,대전,질병,42,50,92
S22,2020,서울,질병,31,61,92
S22,2020,인천,질병,1,8,9
S22,2021,광주,질병,33,75,108
S22,2021,대구,질병,33,46,79
S22,2021,대전,질병,34,31,65
S22,2021,부산,질병,33,19,52
S22,2021,서울,질병,21,47,68
S22,2021,인천,질병,2,7,9
S22,2022,광주,질병,22,21,43
S22,2022,대구,질병,33,26,59
S22,2022,대전,질병,18,44,62
S22,2022,부산,질병,21,24,45
S22,2022,서울,질병,21,39,60
S22,2022,인천,질병,0,5,5
S22,2023,광주,질병,40,38,78
S22,2023,대구,질병,34,45,79
S22,2023,대전,질병,40,50,90
S22,2023,부산,질병,34,15,49
S22,2023,서울,질병,36,50,86
S22,2023,인천,질병,3,13,16
S23,2019,광주,질병,2,2,4
S23,2019,부산,질병,1,0,1
S23,2020,광주,질병,0,2,2
S23,2021,광주,질병,0,2,2
S23,2021,대전,질병,0,1,1
S23,2022,광주,질병,0,2,2
S23,2022,대전,질병,0,3,3
S23,2023,광주,질병,0,1,1
S23,2023,대전,질병,1,0,1
S23,2023,서울,질병,0,1,1
S23,2023,인천,질병,0,1,1
S24,2019,광주,질병,1,0,1
S24,2021,서울,질병,0,1,1
S24,2022,광주,질병,1,0,1
S24,2023,광주,질병,0,2,2
S25,2021,서울,질병,0,1,1
S26,2021,서울,질병,0,2,2
S26,2022,서울,질병,1,0,1
S27,2019,대구,질병,2,0,2
S27,2019,대전,질병,2,4,6
S27,2019,서울,질병,6,4,10
S27,2020,대구,질병,1,0,1
S27,2020,대전,질병,0,2,2
S27,2020,서울,질병,10,11,21
S27,2021,대구,질병,1,1,2
S27,2021,서울,질병,5,7,12
S27,2022,대구,질병,3,0,3
S27,2022,대전,질병,0,3,3
S27,2022,서울,질병,12,7,19
S27,2023,대전,질병,5,4,9
S27,2023,서울,질병,6,6,12
S29,2020,서울,질병,0,1,1
S30,2019,광주,질병,2,0,2
S30,2019,대구,질병,0,1,1
S30,2019,대전,질병,0,1,1
S30,2019,부산,질병,0,1,1
S30,2020,광주,질병,0,1,1
S30,2020,서울,질병,6,4,10
S30,2021,부산,질병,0,1,1
S30,2021,서울,질병,0,2,2
S30,2021,인천,질병,0,1,1
S30,2022,광주,질병,2,0,2
S30,2022,대구,질병,1,0,1
S30,2022,대전,질병,1,1,2
S30,2022,부산,질병,0,1,1
S30,2022,서울,질병,2,1,3
S30,2023,광주,질병,1,1,2
S30,2023,대전,질병,0,2,2
S30,2023,부산,질병,0,1,1
S30,2023,서울,질병,1,1,2
S31,2019,광주,질병,0,1,1
S31,2019,대구,질병,1,0,1
S31,2019,서울,질병,0,1,1
S31,2020,광주,질병,1,0,1
S31,2020,서울,질병,1,2,3
S31,2021,부산,질병,1,0,1
S31,2023,서울,질병,1,0,1
S32,2019,광주,질병,27,58,85
S32,2019,대구,질병,60,78,138
S32,2019,대전,질병,36,60,96
S32,2019,부산,질병,62,49,111
S32,2019,서울,질병,33,67,100
S32,2019,인천,질병,0,10,10
S32,2020,광주,질병,23,69,92
S32,2020,대구,질병,39,65,104
S32,2020,대전,질병,20,47,67
S32,2020,서울,질병,39,83,122
S32,2020,인천,질병,2,13,15
S32,2021,광주,질병,46,80,126
S32,2021,대구,질병,63,72,135
S32,2021,대전,질병,33,63,96
S32,2021,부산,질병,37,35,72
S32,2021,서울,질병,54,72,126
S32,2021,인천,질병,2,12,14
S32,2022,광주,질병,4,12,16
S32,2022,대구,질병,69,47,116
S32,2022,대전,질병,48,63,111
S32,2022,부산,질병,46,32,78
S32,2022,서울,질병,41,105,146
S32,2022,인천,질병,2,2,4
S32,2023,광주,질병,19,34,53
S32,2023,대구,질병,62,77,139
S32,2023,대전,질병,24,61,85
S32,2023,부산,질병,52,40,92
S32,2023,서울,질병,69,116,185
S32,2023,인천,질병,3,6,9
S33,2019,광주,질병,4,15,19
S33,2019,대구,질병,2,6,8
S33,2019,대전,질병,6,9,15
S33,2019,부산,질병,19,6,25
S33,2019,서울,질병,4,5,9
S33,2019,인천,질병,1,0,1
S33,2020,광주,질병,5,18,23
S33,2020,대구,질병,3,2,5
S33,2020,대전,질병,6,6,12
S33,2020,서울,질병,0,2,2
S33,2020,인천,질병,1,3,4
S33,2021,광주,질병,5,6,11
S33,2021,대구,질병,6,10,16
S33,2021,대전,질병,0,2,2
S33,2021,부산,질병,12,3,15
S33,2021,서울,질병,0,2,2
S33,2021,인천,질병,0,5,5
S33,2022,광주,질병,3,6,9
S33,2022,대구,질병,1,4,5
S33,2022,대전,질병,2,6,8
S33,2022,부산,질병,7,11,18
S33,2022,서울,질병,1,3,4
S33,2023,광주,질병,6,9,15
S33,2023,대구,질병,2,0,2
S33,2023,대전,질병,4,5,9
S33,2023,부산,질병,11,4,15
S33,2023,서울,질병,0,4,4
S33,2023,인천,질병,0,4,4
S34,2019,대전,질병,3,0,3
S34,2019,서울,질병,1,0,1
S34,2020,광주,질병,2,0,2
S34,2020,대전,질병,3,0,3
S34,2020,서울,질병,0,2,2
S34,2021,대전,질병,3,0,3
S34,2021,서울,질병,1,2,3
S34,2023,광주,질병,1,0,1
S35,2020,서울,질병,0,3,3
S35,2021,대구,질병,0,1,1
S35,2021,서울,질병,3,0,3
S35,2022,대구,질병,1,0,1
S35,2022,부산,질병,1,0,1
S35,2022,서울,질병,1,0,1
S36,2019,광주,질병,1,0,1
S36,2019,대구,질병,0,1,1
S36,2019,서울,질병,5,5,10
S36,2020,대전,질병,0,1,1
S36,2020,서울,질병,4,4,8
S36,2021,광주,질병,1,0,1
S36,2021,서울,질병,9,5,14
S36,2022,서울,질병,5,1,6
S37,2019,광주,질병,0,1,1
S37,2019,대구,질병,0,1,1
S37,2019,대전,질병,1,2,3
S37,2019,서울,질병,7,4,11
S37,2020,광주,질병,0,1,1
S37,2020,대구,질병,1,0,1
S37,2020,대전,질병,3,0,3
S37,2020,서울,질병,4,4,8
S37,2021,부산,질병,2,1,3
S37,2021,서울,질병,13,15,28
S37,2022,대전,질병,1,0,1
S37,2022,부산,질병,1,2,3
S37,2022,서울,질병,14,16,30
S37,2023,대구,질병,1,1,2
S37,2023,대전,질병,0,1,1
S37,2023,서울,질병,6,13,19
S39,2021,대구,질병,1,0,1
S39,2021,서울,질병,0,1,1
S39,2023,대구,질병,1,0,1
S40,2019,광주,질병,0,1,1
S40,2019,부산,질병,2,0,2
S40,2019,서울,질병,2,0,2
S40,2020,광주,질병,1,1,2
S40,2020,대구,질병,1,0,1
S40,2020,서울,질병,3,2,5
S40,2021,대전,질병,1,0,1
S40,2022,서울,질병,1,1,2
S40,2023,부산,질병,0,1,1
S40,2023,서울,질병,5,1,6
S41,2019,대전,질병,1,0,1
S41,2021,서울,질병,2,0,2
S41,2022,광주,질병,0,1,1
S41,2022,서울,질병,0,1,1
S41,2023,대구,질병,0,1,1
S41,2023,서울,질병,1,0,1
S42,2019,광주,질병,10,19,29
S42,2019,대구,질병,8,4,12
S42,2019,대전,질병,9,5,14
S42,2019,부산,질병,11,4,15
S42,2019,서울,질병,25,29,54
S42,2019,인천,질병,1,2,3
S42,2020,광주,질병,7,18,25
S42,2020,대구,질병,8,8,16
S42,2020,대전,질병,14,14,28
S42,2020,서울,질병,22,30,52
S42,2020,인천,질병,0,2,2
S42,2021,광주,질병,15,21,36
S42,2021,대구,질병,7,10,17
S42,2021,대전,질병,9,7,16
S42,2021,부산,질병,12,6,18
S42,2021,서울,질병,18,32,50
S42,2021,인천,질병,1,3,4
S42,2022,광주,질병,6,9,15
S42,2022,대구,질병,11,5,16
S42,2022,대전,질병,4,7,11
S42,2022,부산,질병,5,4,9
S42,2022,서울,질병,21,23,44
S42,2022,인천,질병,1,1,2
S42,2023,광주,질병,8,12,20
S42,2023,대구,질병,12,7,19
S42,2023,대전,질병,6,14,20
S42,2023,부산,질병,9,3,12
S42,2023,서울,질병,17,41,58
S42,2023,인천,질병,0,3,3
S43,2019,광주,질병,0,7,7
S43,2019,대구,질병,0,1,1
S43,2019,대전,질병,2,1,3
S43,2019,부산,질병,1,1,2
S43,2019,서울,질병,3,8,11
S43,2019,인천,질병,1,0,1
S43,2020,광주,질병,2,3,5
S43,2020,대구,질병,2,0,2
S43,2020,대전,질병,1,2,3
S43,2020,서울,질병,3,3,6
S43,2021,광주,질병,4,1,5
S43,2021,대전,질병,3,3,6
S43,2021,부산,질병,1,3,4
S43,2021,서울,질병,7,5,12
S43,2022,광주,질병,3,2,5
S43,2022,대구,질병,2,1,3
S43,2022,대전,질병,4,2,6
S43,2022,부산,질병,0,1,1
S43,2022,서울,질병,5,4,9
S43,2022,인천,질병,0,1,1
S43,2023,대구,질병,3,4,7
S43,2023,대전,질병,1,2,3
S43,2023,부산,질병,0,2,2
S43,2023,서울,질병,5,2,7
S46,2019,광주,질병,14,6,20
S46,2019,대구,질병,2,0,2
S46,2019,대전,질병,4,5,9
S46,2019,부산,질병,70,21,91
S46,2019,서울,질병,2,2,4
S46,2019,인천,질병,2,2,4
S46,2020,광주,질병,6,1,7
S46,2020,대구,질병,0,1,1
S46,2020,대전,질병,3,6,9
S46,2020,서울,질병,0,2,2
S46,2020,인천,질병,0,2,2
S46,2021,광주,질병,4,2,6
S46,2021,대구,질병,4,4,8
S46,2021,대전,질병,3,4,7
S46,2021,부산,질병,94,27,121
S46,2021,서울,질병,6,4,10
S46,2022,광주,질병,4,1,5
S46,2022,대구,질병,3,2,5
S46,2022,대전,질병,8,5,13
S46,2022,부산,질병,78,25,103
S46,2022,서울,질병,11,9,20
S46,2022,인천,질병,1,1,2
S46,2023,광주,질병,3,5,8
S46,2023,대구,질병,2,4,6
S46,2023,대전,질병,7,9,16
S46,2023,부산,질병,97,29,126
S46,2023,서울,질병,19,17,36
S46,2023,인천,질병,2,0,2
S48,2019,서울,질병,0,1,1
S49,2019,대전,질병,1,0,1
S49,2023,대전,질병,1,0,1
S50,2019,광주,질병,2,0,2
S50,2019,서울,질병,2,1,3
S50,2019,인천,질병,1,0,1
S50,2021,대구,질병,0,1,1
S50,2021,서울,질병,0,3,3
S50,2022,대구,질병,1,0,1
S50,2022,서울,질병,0,1,1
S50,2023,대전,질병,1,0,1
S50,2023,서울,질병,2,2,4
S51,2019,대전,질병,0,1,1
S51,2019,서울,질병,1,1,2
S51,2019,인천,질병,0,1,1
S51,2020,광주,질병,2,0,2
S51,2020,대전,질병,1,1,2
S51,2020,서울,질병,1,0,1
S51,2021,대구,질병,3,0,3
S51,2021,서울,질병,2,0,2
S51,2022,광주,질병,1,0,1
S51,2023,대구,질병,1,0,1
S51,2023,서울,질병,0,1,1
S52,2019,광주,질병,11,47,58
S52,2019,대구,질병,9,21,30
S52,2019,대전,질병,8,24,32
S52,2019,부산,질병,9,12,21
S52,2019,서울,질병,12,39,51
S52,2019,인천,질병,0,1,1
S52,2020,광주,질병,9,31,40
S52,2020,대구,질병,7,21,28
S52,2020,대전,질병,7,15,22
S52,2020,서울,질병,10,28,38
S52,2020,인천,질병,0,2,2
S52,2021,광주,질병,13,40,53
S52,2021,대구,질병,6,17,23
S52,2021,대전,질병,14,9,23
S52,2021,부산,질병,5,7,12
S52,2021,서울,질병,12,25,37
S52,2021,인천,질병,0,3,3
S52,2022,광주,질병,6,23,29
S52,2022,대구,질병,12,9,21
S52,2022,대전,질병,21,17,38
S52,2022,부산,질병,7,5,12
S52,2022,서울,질병,7,20,27
S52,2023,광주,질병,8,21,29
S52,2023,대구,질병,10,11,21
S52,2023,대전,질병,7,25,32
S52,2023,부산,질병,8,17,25
S52,2023,서울,질병,7,33,40
S52,2023,인천,질병,2,5,7
S53,2019,대구,질병,1,0,1
S53,2019,서울,질병,2,0,2
S53,2020,대구,질병,1,0,1
S53,2020,서울,질병,0,2,2
S53,2020,인천,질병,0,1,1
S53,2021,광주,질병,2,0,2
S53,2021,부산,질병,1,0,1
S53,2022,서울,질병,6,0,6
S53,2023,광주,질병,0,2,2
S53,2023,대구,질병,1,1,2
S53,2023,서울,질병,1,1,2
S54,2021,서울,질병,1,0,1
S56,2019,부산,질병,7,1,8
S56,2021,광주,질병,1,0,1
S56,2021,부산,질병,5,0,5
S56,2022,부산,질병,2,2,4
S56,2022,서울,질병,1,0,1
S56,2023,광주,질병,1,0,1
S56,2023,대구,질병,1,0,1
S56,2023,부산,질병,1,1,2
S58,2023,광주,질병,2,0,2
S59,2019,대구,질병,0,1,1
S59,2019,인천,질병,0,1,1
S59,2020,인천,질병,0,1,1
S59,2021,부산,질병,3,1,4
S59,2021,인천,질병,0,1,1
S59,2023,광주,질병,0,1,1
S59,2023,부산,질병,1,0,1
S60,2019,대구,질병,1,0,1
S60,2019,대전,질병,0,1,1
S60,2019,서울,질병,1,0,1
S60,2020,광주,질병,1,0,1
S60,2020,서울,질병,0,1,1
S60,2021,서울,질병,3,2,5
S60,2022,서울,질병,1,1,2
S60,2023,서울,질병,2,0,2
S61,2019,광주,질병,0,1,1
S61,2019,대구,질병,1,0,1
S61,2019,대전,질병,2,0,2
S61,2019,서울,질병,1,1,2
S61,2020,광주,질병,1,1,2
S61,2020,대구,질병,2,0,2
S61,2020,대전,질병,1,0,1
S61,2020,서울,질병,1,0,1
S61,2021,광주,질병,1,0,1
S61,2021,대구,질병,1,0,1
S61,2021,대전,질병,4,2,6
S61,2021,서울,질병,0,3,3
S61,2022,광주,질병,0,1,1
S61,2022,대구,질병,2,1,3
S61,2022,대전,질병,1,0,1
S61,2022,서울,질병,1,0,1
S61,2023,광주,질병,2,4,6
S61,2023,대구,질병,1,3,4
S61,2023,대전,질병,1,0,1
S61,2023,서울,질병,2,1,3
S61,2023,인천,질병,0,1,1
S62,2019,광주,질병,7,5,12
S62,2019,대구,질병,4,3,7
S62,2019,대전,질병,6,5,11
S62,2019,부산,질병,6,2,8
S62,2019,서울,질병,9,9,18
S62,2020,광주,질병,4,6,10
S62,2020,대구,질병,7,3,10
S62,2020,대전,질병,7,2,9
S62,2020,서울,질병,11,4,15
S62,2020,인천,질병,1,3,4
S62,2021,광주,질병,8,8,16
S62,2021,대구,질병,4,5,9
S62,2021,대전,질병,13,6,19
S62,2021,부산,질병,6,2,8
S62,2021,서울,질병,1,6,7
S62,2021,인천,질병,1,1,2
S62,2022,광주,질병,6,2,8
S62,2022,대구,질병,5,1,6
S62,2022,대전,질병,6,4,10
S62,2022,부산,질병,4,0,4
S62,2022,서울,질병,7,10,17
S62,2022,인천,질병,0,1,1
S62,2023,광주,질병,5,5,10
S62,2023,대구,질병,6,2,8
S62,2023,대전,질병,2,4,6
S62,2023,부산,질병,5,1,6
S62,2023,서울,질병,8,1,9
S62,2023,인천,질병,0,3,3
S63,2019,대구,질병,1,0,1
S63,2019,대전,질병,0,1,1
S63,2019,부산,질병,1,0,1
S63,2019,서울,질병,1,0,1
S63,2020,대전,질병,1,0,1
S63,2020,서울,질병,2,2,4
S63,2021,서울,질병,1,0,1
S63,2022,대구,질병,1,0,1
S63,2022,대전,질병,2,0,2
S63,2022,부산,질병,2,0,2
S63,2022,서울,질병,0,1,1
S63,2023,대전,질병,1,0,1
S63,2023,부산,질병,1,0,1
S63,2023,서울,질병,1,2,3
S64,2019,서울,질병,1,0,1
S64,2021,서울,질병,0,1,1
S65,2019,광주,질병,3,0,3
S65,2020,광주,질병,1,0,1
S65,2023,광주,질병,1,0,1
S66,2019,광주,질병,2,1,3
S66,2019,대구,질병,0,1,1
S66,2019,대전,질병,0,2,2
S66,2020,광주,질병,1,3,4
S66,2020,대구,질병,0,1,1
S66,2020,대전,질병,0,2,2
S66,2020,인천,질병,0,1,1
S66,2021,광주,질병,1,2,3
S66,2021,대전,질병,3,2,5
S66,2022,광주,질병,1,0,1
S66,2022,대구,질병,1,0,1
S66,2022,대전,질병,0,1,1
S66,2023,광주,질병,2,0,2
S66,2023,서울,질병,1,0,1
S66,2023,인천,질병,0,1,1
S67,2019,광주,질병,0,1,1
S67,2020,대구,질병,0,3,3
S67,2020,대전,질병,1,0,1
S67,2021,대전,질병,1,0,1
S68,2019,광주,질병,2,0,2
S68,2020,광주,질병,3,1,4
S68,2021,광주,질병,2,0,2
S68,2022,광주,질병,2,0,2
S68,2023,광주,질병,2,0,2
S69,2019,광주,질병,0,1,1
S69,2019,부산,질병,1,0,1
S69,2020,광주,질병,1,1,2
S69,2020,서울,질병,0,1,1
S69,2020,인천,질병,0,2,2
S69,2021,광주,질병,0,1,1
S69,2021,인천,질병,1,0,1
S69,2022,광주,질병,1,0,1
S69,2022,대전,질병,2,0,2
S69,2022,인천,질병,0,1,1
S69,2023,대구,질병,1,0,1
S69,2023,서울,질병,0,1,1
S70,2019,광주,질병,2,1,3
S70,2019,대구,질병,7,1,8
S70,2019,대전,질병,7,2,9
S70,2019,서울,질병,3,2,5
S70,2019,인천,질병,0,1,1
S70,2020,광주,질병,2,0,2
S70,2020,대구,질병,1,1,2
S70,2020,대전,질병,2,1,3
S70,2020,서울,질병,4,2,6
S70,2021,광주,질병,4,1,5
S70,2021,대구,질병,1,1,2
S70,2021,대전,질병,1,1,2
S70,2021,서울,질병,1,0,1
S70,2022,광주,질병,1,0,1
S70,2022,대구,질병,1,0,1
S70,2022,대전,질병,1,1,2
S70,2022,서울,질병,1,2,3
S70,2023,광주,질병,0,3,3
S70,2023,대구,질병,0,2,2
S70,2023,대전,질병,1,1,2
S70,2023,부산,질병,1,0,1
S70,2023,서울,질병,1,3,4
S71,2019,서울,질병,1,0,1
S71,2020,광주,질병,0,1,1
S71,2020,대전,질병,0,2,2
S71,2021,대전,질병,0,1,1
S72,2019,광주,질병,30,79,109
S72,2019,대구,질병,16,43,59
S72,2019,대전,질병,14,51,65
S72,2019,부산,질병,32,8,40
S72,2019,서울,질병,60,146,206
S72,2019,인천,질병,0,7,7
S72,2020,광주,질병,21,65,86
S72,2020,대구,질병,17,24,41
S72,2020,대전,질병,11,29,40
S72,2020,서울,질병,51,111,162
S72,2020,인천,질병,3,7,10
S72,2021,광주,질병,18,76,94
S72,2021,대구,질병,20,25,45
S72,2021,대전,질병,9,30,39
S72,2021,부산,질병,13,10,23
S72,2021,서울,질병,40,101,141
S72,2021,인천,질병,1,3,4
S72,2022,광주,질병,12,29,41
S72,2022,대구,질병,18,21,39
S72,2022,대전,질병,18,53,71
S72,2022,부산,질병,14,10,24
S72,2022,서울,질병,46,107,153
S72,2022,인천,질병,1,4,5
S72,2023,광주,질병,20,52,72
S72,2023,대구,질병,23,23,46
S72,2023,대전,질병,29,56,85
S72,2023,부산,질병,21,10,31
S72,2023,서울,질병,61,124,185
S72,2023,인천,질병,2,9,11
S73,2019,광주,질병,0,3,3
S73,2019,대전,질병,2,0,2
S73,2019,부산,질병,1,0,1
S73,2019,서울,질병,1,3,4
S73,2020,광주,질병,0,3,3
S73,2020,대구,질병,1,0,1
S73,2020,서울,질병,2,1,3
S73,2021,대전,질병,1,1,2
S73,2021,서울,질병,0,2,2
S73,2022,광주,질병,1,0,1
S73,2022,대구,질병,1,0,1
S73,2022,대전,질병,0,1,1
S73,2022,서울,질병,1,2,3
S73,2023,광주,질병,3,3,6
S73,2023,대구,질병,1,0,1
S73,2023,서울,질병,4,1,5
S75,2020,대구,질병,0,1,1
S75,2023,광주,질병,1,0,1
S76,2019,광주,질병,1,0,1
S76,2020,광주,질병,2,1,3
S76,2020,서울,질병,0,1,1
S76,2021,대구,질병,0,1,1
S76,2022,인천,질병,0,1,1
S76,2023,광주,질병,1,1,2
S76,2023,대구,질병,1,1,2
S76,2023,서울,질병,1,3,4
S77,2023,대구,질병,0,1,1
S78,2019,대전,질병,2,0,2
S78,2019,서울,질병,1,0,1
S78,2020,대전,질병,1,0,1
S78,2020,서울,질병,1,0,1
S78,2022,대전,질병,1,0,1
S78,2022,서울,질병,0,1,1
S78,2023,서울,질병,0,1,1
S79,2021,서울,질병,1,2,3
S79,2022,부산,질병,0,1,1
S80,2019,광주,질병,3,1,4
S80,2019,대구,질병,1,1,2
S80,2019,대전,질병,1,3,4
S80,2019,서울,질병,2,3,5
S80,2020,광주,질병,1,1,2
S80,2020,대구,질병,0,1,1
S80,2020,대전,질병,5,2,7
S80,2020,서울,질병,2,3,5
S80,2021,대구,질병,1,0,1
S80,2021,서울,질병,4,3,7
S80,2022,광주,질병,1,0,1
S80,2022,대전,질병,1,1,2
S80,2022,부산,질병,1,0,1
S80,2022,서울,질병,0,3,3
S80,2023,광주,질병,2,2,4
S80,2023,대구,질병,5,1,6
S80,2023,대전,질병,3,0,3
S80,2023,부산,질병,0,1,1
S80,2023,서울,질병,5,4,9
S80,2023,인천,질병,1,0,1
S81,2019,광주,질병,0,3,3
S81,2019,대구,질병,0,1,1
S81,2019,대전,질병,1,1,2
S81,2019,부산,질병,4,0,4
S81,2019,서울,질병,1,4,5
S81,2020,대구,질병,2,0,2
S81,2020,대전,질병,1,1,2
S81,2020,서울,질병,2,5,7
S81,2021,대구,질병,0,1,1
S81,2021,대전,질병,2,0,2
S81,2021,서울,질병,4,5,9
S81,2022,광주,질병,3,0,3
S81,2022,대구,질병,2,0,2
S81,2022,부산,질병,3,1,4
S81,2022,서울,질병,4,6,10
S81,2023,광주,질병,2,0,2
S81,2023,대구,질병,1,2,3
S81,2023,대전,질병,0,1,1
S81,2023,서울,질병,1,4,5
S82,2019,광주,질병,20,45,65
S82,2019,대구,질병,21,21,42
S82,2019,대전,질병,8,20,28
S82,2019,부산,질병,23,12,35
S82,2019,서울,질병,24,46,70
S82,2019,인천,질병,4,4,8
S82,2020,광주,질병,16,28,44
S82,2020,대구,질병,11,14,25
S82,2020,대전,질병,14,14,28
S82,2020,서울,질병,17,36,53
S82,2020,인천,질병,1,7,8
S82,2021,광주,질병,27,25,52
S82,2021,대구,질병,15,16,31
S82,2021,대전,질병,14,8,22
S82,2021,부산,질병,21,12,33
S82,2021,서울,질병,26,42,68
S82,2021,인천,질병,2,2,4
S82,2022,광주,질병,12,12,24
S82,2022,대구,질병,20,6,26
S82,2022,대전,질병,9,21,30
S82,2022,부산,질병,10,18,28
S82,2022,서울,질병,32,50,82
S82,2022,인천,질병,1,5,6
S82,2023,광주,질병,17,20,37
S82,2023,대구,질병,10,19,29
S82,2023,대전,질병,16,19,35
S82,2023,부산,질병,6,10,16
S82,2023,서울,질병,25,57,82
S82,2023,인천,질병,3,9,12
S83,2019,광주,질병,7,12,19
S83,2019,대구,질병,13,1,14
S83,2019,대전,질병,6,4,10
S83,2019,부산,질병,13,4,17
S83,2019,서울,질병,11,4,15
S83,2019,인천,질병,3,2,5
S83,2020,광주,질병,12,12,24
S83,2020,대구,질병,5,10,15
S83,2020,대전,질병,5,4,9
S83,2020,서울,질병,3,5,8
S83,2020,인천,질병,2,2,4
S83,2021,광주,질병,10,6,16
S83,2021,대구,질병,7,6,13
S83,2021,대전,질병,3,2,5
S83,2021,부산,질병,10,5,15
S83,2021,서울,질병,4,6,10
S83,2021,인천,질병,0,1,1
S83,2022,광주,질병,3,6,9
S83,2022,대구,질병,9,1,10
S83,2022,대전,질병,10,4,14
S83,2022,부산,질병,9,4,13
S83,2022,서울,질병,3,12,15
S83,2022,인천,질병,0,1,1
S83,2023,광주,질병,6,7,13
S83,2023,대구,질병,6,4,10
S83,2023,대전,질병,8,9,17
S83,2023,부산,질병,6,1,7
S83,2023,서울,질병,4,4,8
S83,2023,인천,질병,3,2,5
S84,2023,대전,질병,1,0,1
S85,2021,대구,질병,1,0,1
S85,2023,광주,질병,2,0,2
S86,2019,광주,질병,1,3,4
S86,2019,대구,질병,1,2,3
S86,2019,대전,질병,2,0,2
S86,2019,서울,질병,2,1,3
S86,2019,인천,질병,1,0,1
S86,2020,광주,질병,0,1,1
S86,2020,대구,질병,1,2,3
S86,2020,대전,질병,1,0,1
S86,2021,광주,질병,1,0,1
S86,2021,대구,질병,1,1,2
S86,2021,대전,질병,1,0,1
S86,2021,부산,질병,1,0,1
S86,2021,서울,질병,1,2,3
S86,2021,인천,질병,1,2,3
S86,2022,광주,질병,1,0,1
S86,2022,대구,질병,1,0,1
S86,2022,대전,질병,1,0,1
S86,2022,서울,질병,1,2,3
S86,2023,광주,질병,3,3,6
S86,2023,대전,질병,2,1,3
S86,2023,서울,질병,4,4,8
S86,2023,인천,질병,1,0,1
S87,2019,서울,질병,0,1,1
S88,2019,대전,질병,2,0,2
S88,2019,서울,질병,2,1,3
S88,2020,서울,질병,0,2,2
S88,2021,대전,질병,3,0,3
S88,2022,광주,질병,0,1,1
S88,2022,대전,질병,3,0,3
S88,2023,대전,질병,2,0,2
S89,2019,대구,질병,1,0,1
S89,2020,광주,질병,0,1,1
S89,2022,대전,질병,0,1,1
S89,2023,대구,질병,1,0,1
S90,2019,광주,질병,1,0,1
S90,2019,대전,질병,2,1,3
S90,2019,부산,질병,10,0,10
S90,2019,서울,질병,0,1,1
S90,2020,광주,질병,1,0,1
S90,2020,대구,질병,2,0,2
S90,2020,서울,질병,1,2,3
S90,2021,부산,질병,2,0,2
S90,2021,서울,질병,0,1,1
S90,2022,대구,질병,2,0,2
S90,2022,서울,질병,1,0,1
S90,2023,대구,질병,1,1,2
S90,2023,대전,질병,0,1,1
S90,2023,서울,질병,2,2,4
S91,2019,광주,질병,1,2,3
S91,2019,대구,질병,1,0,1
S91,2019,대전,질병,2,0,2
S91,2019,서울,질병,1,1,2
S91,2020,광주,질병,0,1,1
S91,2020,대구,질병,1,0,1
S91,2020,대전,질병,2,1,3
S91,2021,광주,질병,0,1,1
S91,2021,대전,질병,1,0,1
S91,2021,서울,질병,1,0,1
S91,2022,대전,질병,1,1,2
S91,2022,서울,질병,3,0,3
S91,2023,광주,질병,3,0,3
S91,2023,대구,질병,2,0,2
S91,2023,서울,질병,0,2,2
S92,2019,광주,질병,17,6,23
S92,2019,대구,질병,6,4,10
S92,2019,대전,질병,8,8,16
S92,2019,부산,질병,10,1,11
S92,2019,서울,질병,9,14,23
S92,2020,광주,질병,15,10,25
S92,2020,대구,질병,9,11,20
S92,2020,대전,질병,17,6,23
S92,2020,서울,질병,6,13,19
S92,2020,인천,질병,1,0,1
S92,2021,광주,질병,9,9,18
S92,2021,대구,질병,2,11,13
S92,2021,대전,질병,7,6,13
S92,2021,부산,질병,7,2,9
S92,2021,서울,질병,12,19,31
S92,2022,광주,질병,1,6,7
S92,2022,대구,질병,9,4,13
S92,2022,대전,질병,6,11,17
S92,2022,부산,질병,6,0,6
S92,2022,서울,질병,10,20,30
S92,2023,광주,질병,5,7,12
S92,2023,대구,질병,13,2,15
S92,2023,대전,질병,7,11,18
S92,2023,부산,질병,4,4,8
S92,2023,서울,질병,10,14,24
S92,2023,인천,질병,2,4,6
S93,2019,광주,질병,3,11,14
S93,2019,대구,질병,2,2,4
S93,2019,대전,질병,1,1,2
S93,2019,부산,질병,4,0,4
S93,2019,서울,질병,1,4,5
S93,2019,인천,질병,0,2,2
S93,2020,광주,질병,3,12,15
S93,2020,대구,질병,2,3,5
S93,2020,대전,질병,0,2,2
S93,2020,서울,질병,1,2,3
S93,2021,광주,질병,3,4,7
S93,2021,대구,질병,1,1,2
S93,2021,대전,질병,1,1,2
S93,2021,부산,질병,5,2,7
S93,2021,서울,질병,3,3,6
S93,2022,광주,질병,0,4,4
S93,2022,대전,질병,1,1,2
S93,2022,부산,질병,4,1,5
S93,2022,서울,질병,3,5,8
S93,2023,광주,질병,3,4,7
S93,2023,대전,질병,1,3,4
S93,2023,부산,질병,2,0,2
S93,2023,서울,질병,2,1,3
S94,2019,대구,질병,1,0,1
S94,2020,대구,질병,1,0,1
S94,2021,대구,질병,1,0,1
S96,2019,광주,질병,1,0,1
S96,2019,부산,질병,1,0,1
S96,2019,서울,질병,1,0,1
S96,2020,광주,질병,1,0,1
S96,2020,대구,질병,1,0,1
S96,2021,광주,질병,0,1,1
S96,2021,대구,질병,1,0,1
S96,2022,대구,질병,3,0,3
S96,2023,대구,질병,2,0,2
S96,2023,서울,질병,0,1,1
S97,2019,서울,질병,1,0,1
S97,2020,대구,질병,0,1,1
S97,2020,서울,질병,0,1,1
S97,2023,대구,질병,2,0,2
S98,2019,인천,질병,2,0,2
S99,2019,부산,질병,2,0,2
S99,2019,서울,질병,1,0,1
S99,2021,광주,질병,0,2,2
S99,2021,부산,질병,1,1,2
S99,2022,부산,질병,2,2,4
S99,2022,서울,질병,1,1,2
S99,2023,부산,질병,1,0,1
T00,2019,광주,질병,0,3,3
T00,2019,부산,질병,1,0,1
T00,2019,서울,질병,0,2,2
T00,2020,광주,질병,4,5,9
T00,2020,대구,질병,1,0,1
T00,2021,광주,질병,6,11,17
T00,2021,대전,질병,2,1,3
T00,2022,광주,질병,2,7,9
T00,2022,대구,질병,1,0,1
T00,2022,대전,질병,1,1,2
T00,2022,부산,질병,0,1,1
T00,2022,서울,질병,1,1,2
T00,2023,광주,질병,2,4,6
T00,2023,대구,질병,1,0,1
T00,2023,대전,질병,1,0,1
T00,2023,부산,질병,0,1,1
T00,2023,서울,질병,1,0,1
T01,2019,부산,질병,0,1,1
T02,2019,광주,질병,0,1,1
T02,2019,인천,질병,0,1,1
T02,2023,서울,질병,0,1,1
T03,2019,대구,질병,0,1,1
T03,2020,서울,질병,0,1,1
T04,2020,대전,질병,0,1,1
T05,2023,서울,질병,0,2,2
T07,2020,광주,질병,1,0,1
T07,2020,대구,질병,0,1,1
T07,2021,광주,질병,0,1,1
T08,2019,광주,질병,3,2,5
T08,2019,부산,질병,4,3,7
T08,2019,서울,질병,4,5,9
T08,2019,인천,질병,0,3,3
T08,2020,광주,질병,1,0,1
T08,2020,서울,질병,1,5,6
T08,2020,인천,질병,1,2,3
T08,2021,광주,질병,0,1,1
T08,2021,부산,질병,1,0,1
T08,2021,서울,질병,0,1,1
T08,2022,대구,질병,1,0,1
T08,2022,부산,질병,0,1,1
T08,2022,서울,질병,1,0,1
T08,2023,부산,질병,2,1,3
T08,2023,서울,질병,1,1,2
T09,2019,광주,질병,2,1,3
T09,2019,대구,질병,0,1,1
T09,2019,대전,질병,2,0,2
T09,2019,부산,질병,1,0,1
T09,2019,서울,질병,5,1,6
T09,2020,광주,질병,3,1,4
T09,2020,대구,질병,1,0,1
T09,2020,대전,질병,1,0,1
T09,2020,서울,질병,2,0,2
T09,2021,광주,질병,2,1,3
T09,2021,대전,질병,1,1,2
T09,2021,부산,질병,2,3,5
T09,2021,서울,질병,0,2,2
T09,2022,광주,질병,4,0,4
T09,2022,부산,질병,2,0,2
T09,2022,서울,질병,0,1,1
T09,2023,광주,질병,3,0,3
T09,2023,대전,질병,1,0,1
T09,2023,부산,질병,1,1,2
T09,2023,서울,질병,1,1,2
T10,2021,광주,질병,1,0,1
T11,2020,서울,질병,1,0,1
T11,2021,서울,질병,0,1,1
T13,2019,광주,질병,0,1,1
T13,2019,부산,질병,1,0,1
T13,2020,광주,질병,1,1,2
T13,2020,대구,질병,2,0,2
T13,2020,대전,질병,0,1,1
T13,2021,부산,질병,1,0,1
T13,2022,대구,질병,1,0,1
T13,2022,서울,질병,1,1,2
T13,2023,광주,질병,1,0,1
T14,2019,광주,질병,2,2,4
T14,2019,대구,질병,8,2,10
T14,2019,대전,질병,0,2,2
T14,2019,부산,질병,8,0,8
T14,2019,서울,질병,8,9,17
T14,2019,인천,질병,0,1,1
T14,2020,광주,질병,3,9,12
T14,2020,대구,질병,1,3,4
T14,2020,서울,질병,5,5,10
T14,2020,인천,질병,1,1,2
T14,2021,광주,질병,15,8,23
T14,2021,대구,질병,1,0,1
T14,2021,부산,질병,2,2,4
T14,2021,서울,질병,6,1,7
T14,2022,광주,질병,4,6,10
T14,2022,대구,질병,3,0,3
T14,2022,대전,질병,4,0,4
T14,2022,부산,질병,4,0,4
T14,2022,서울,질병,0,1,1
T14,2023,광주,질병,7,5,12
T14,2023,대구,질병,2,0,2
T14,2023,대전,질병,0,3,3
T14,2023,부산,질병,6,1,7
T14,2023,서울,질병,3,2,5
T15,2019,서울,질병,1,0,1
T15,2020,서울,질병,1,0,1
T16,2022,서울,질병,1,0,1
T17,2019,광주,질병,0,1,1
T17,2019,대구,질병,1,0,1
T17,2019,서울,질병,11,2,13
T17,2020,대구,질병,1,1,2
T17,2020,서울,질병,5,5,10
T17,2021,대구,질병,1,0,1
T17,2021,서울,질병,2,1,3
T17,2022,서울,질병,5,1,6
T17,2023,부산,질병,1,0,1
T17,2023,서울,질병,3,4,7
T18,2019,광주,질병,1,3,4
T18,2019,대전,질병,2,1,3
T18,2019,서울,질병,1,1,2
T18,2020,광주,질병,3,0,3
T18,2020,대전,질병,1,2,3
T18,2020,서울,질병,1,2,3
T18,2021,대전,질병,3,0,3
T18,2021,부산,질병,3,0,3
T18,2021,서울,질병,8,2,10
T18,2022,광주,질병,1,0,1
T18,2022,대전,질병,1,0,1
T18,2022,서울,질병,3,4,7
T18,2023,광주,질병,3,0,3
T18,2023,대전,질병,1,0,1
T18,2023,서울,질병,1,2,3
T19,2019,대전,질병,0,1,1
T19,2019,서울,질병,1,0,1
T19,2020,광주,질병,1,0,1
T19,2020,대구,질병,1,0,1
T19,2021,부산,질병,1,0,1
T19,2022,서울,질병,0,1,1
T19,2023,서울,질병,0,2,2
T20,2021,서울,질병,1,0,1
T20,2023,대구,질병,0,1,1
T21,2019,대구,질병,2,0,2
T21,2019,대전,질병,2,0,2
T21,2019,서울,질병,2,0,2
T21,2020,광주,질병,1,0,1
T21,2020,대구,질병,2,0,2
T21,2020,서울,질병,2,1,3
T21,2021,광주,질병,1,0,1
T21,2021,대전,질병,2,0,2
T21,2021,서울,질병,1,1,2
T21,2022,대구,질병,1,0,1
T21,2022,대전,질병,1,0,1
T21,2022,서울,질병,2,0,2
T21,2023,대전,질병,0,1,1
T21,2023,서울,질병,2,2,4
T22,2021,대구,질병,1,0,1
T22,2021,인천,질병,0,1,1
T22,2023,서울,질병,1,1,2
T23,2019,광주,질병,1,0,1
T23,2019,대구,질병,1,0,1
T23,2020,광주,질병,0,1,1
T23,2020,대구,질병,0,1,1
T23,2020,대전,질병,1,0,1
T23,2022,서울,질병,0,2,2
T24,2019,대구,질병,1,1,2
T24,2019,대전,질병,1,0,1
T24,2019,부산,질병,1,0,1
T24,2019,서울,질병,2,0,2
T24,2020,광주,질병,0,1,1
T24,2020,대전,질병,1,0,1
T24,2020,서울,질병,2,2,4
T24,2021,대전,질병,2,1,3
T24,2021,부산,질병,1,0,1
T24,2021,서울,질병,0,1,1
T24,2022,광주,질병,0,1,1
T24,2022,대구,질병,2,0,2
T24,2022,대전,질병,3,0,3
T24,2022,부산,질병,2,0,2
T24,2022,서울,질병,1,0,1
T24,2023,광주,질병,1,1,2
T24,2023,대전,질병,0,1,1
T24,2023,부산,질병,1,0,1
T24,2023,서울,질병,3,2,5
T25,2019,광주,질병,0,1,1
T25,2019,대구,질병,3,0,3
T25,2019,대전,질병,2,0,2
T25,2019,부산,질병,3,0,3
T25,2019,서울,질병,1,1,2
T25,2020,광주,질병,4,0,4
T25,2020,대구,질병,2,0,2
T25,2020,대전,질병,1,0,1
T25,2020,서울,질병,1,1,2
T25,2021,광주,질병,1,0,1
T25,2021,부산,질병,2,0,2
T25,2021,인천,질병,0,1,1
T25,2022,대전,질병,1,0,1
T25,2022,부산,질병,1,0,1
T25,2022,서울,질병,0,1,1
T25,2023,대구,질병,1,0,1
T25,2023,부산,질병,2,0,2
T25,2023,서울,질병,3,0,3
T27,2020,광주,질병,0,1,1
T27,2021,서울,질병,0,1,1
T28,2019,대구,질병,1,0,1
T28,2019,서울,질병,1,0,1
T28,2020,대구,질병,5,0,5
T28,2021,서울,질병,0,1,1
T30,2019,광주,질병,1,1,2
T30,2019,대구,질병,1,0,1
T30,2019,대전,질병,1,0,1
T30,2019,부산,질병,6,1,7
T30,2020,광주,질병,1,1,2
T30,2020,대구,질병,1,1,2
T30,2020,대전,질병,3,0,3
T30,2021,광주,질병,0,1,1
T30,2021,대구,질병,2,0,2
T30,2021,대전,질병,2,1,3
T30,2021,부산,질병,5,1,6
T30,2022,광주,질병,0,3,3
T30,2022,대전,질병,4,0,4
T30,2022,부산,질병,2,0,2
T30,2023,광주,질병,5,1,6
T30,2023,부산,질병,4,0,4
T31,2019,부산,질병,1,0,1
T35,2020,대구,질병,0,1,1
T36,2020,서울,질병,1,1,2
T36,2022,서울,질병,1,0,1
T38,2021,서울,질병,0,1,1
T38,2023,대구,질병,0,1,1
T39,2023,서울,질병,0,1,1
T40,2019,서울,질병,1,0,1
T40,2022,서울,질병,1,0,1
T40,2023,서울,질병,1,1,2
T41,2023,서울,질병,0,1,1
T42,2019,대구,질병,1,0,1
T42,2020,광주,질병,1,0,1
T42,2020,서울,질병,1,2,3
T42,2021,광주,질병,0,1,1
T42,2022,광주,질병,1,0,1
T42,2022,대구,질병,1,0,1
T42,2022,서울,질병,1,3,4
T42,2023,대구,질병,0,1,1
T42,2023,서울,질병,1,1,2
T44,2023,서울,질병,0,2,2
T45,2020,서울,질병,0,2,2
T45,2021,부산,질병,1,0,1
T46,2019,서울,질병,0,1,1
T46,2022,서울,질병,0,1,1
T50,2019,광주,질병,1,0,1
T50,2019,부산,질병,3,1,4
T50,2019,서울,질병,0,1,1
T50,2020,서울,질병,2,0,2
T50,2021,부산,질병,0,2,2
T50,2021,서울,질병,1,0,1
T50,2023,서울,질병,0,3,3
T54,2021,대전,질병,0,1,1
T55,2020,서울,질병,0,1,1
T60,2020,광주,질병,1,0,1
T60,2022,광주,질병,0,1,1
T60,2022,대구,질병,1,0,1
T62,2020,광주,질병,0,2,2
T63,2019,서울,질병,1,0,1
T63,2020,광주,질병,1,0,1
T63,2020,대구,질병,1,0,1
T63,2020,서울,질병,1,0,1
T63,2021,광주,질병,1,0,1
T63,2022,광주,질병,1,0,1
T63,2022,대전,질병,0,3,3
T63,2023,광주,질병,1,0,1
T65,2019,광주,질병,0,1,1
T65,2019,부산,질병,1,0,1
T65,2020,광주,질병,0,2,2
T65,2020,대구,질병,2,0,2
T65,2020,서울,질병,0,1,1
T66,2023,서울,질병,1,0,1
T67,2020,서울,질병,1,0,1
T67,2022,대전,질병,0,1,1
T67,2023,서울,질병,0,1,1
T68,2019,서울,질병,0,1,1
T68,2020,서울,질병,0,2,2
T68,2022,광주,질병,0,1,1
T68,2022,서울,질병,1,0,1
T68,2023,대구,질병,1,0,1
T71,2019,서울,질병,1,0,1
T71,2020,서울,질병,1,0,1
T71,2022,대구,질병,1,0,1
T71,2023,서울,질병,0,2,2
T75,2021,부산,질병,2,0,2
T75,2022,부산,질병,1,0,1
T78,2019,광주,질병,0,1,1
T78,2019,대구,질병,0,1,1
T78,2019,부산,질병,1,0,1
T78,2019,서울,질병,0,2,2
T78,2020,광주,질병,1,0,1
T78,2020,대구,질병,1,0,1
T78,2020,서울,질병,1,0,1
T78,2021,광주,질병,0,1,1
T78,2021,서울,질병,0,1,1
T78,2022,서울,질병,0,1,1
T78,2023,광주,질병,0,1,1
T78,2023,대구,질병,0,1,1
T78,2023,부산,질병,1,0,1
T78,2023,서울,질병,2,0,2
T79,2019,부산,질병,3,0,3
T79,2019,서울,질병,4,1,5
T79,2020,광주,질병,2,3,5
T79,2020,대구,질병,1,0,1
T79,2020,서울,질병,5,0,5
T79,2021,광주,질병,0,1,1
T79,2021,대구,질병,1,1,2
T79,2021,서울,질병,2,1,3
T79,2021,인천,질병,0,1,1
T79,2022,대구,질병,3,0,3
T79,2022,부산,질병,0,1,1
T79,2022,서울,질병,0,5,5
T79,2023,광주,질병,1,1,2
T79,2023,대구,질병,1,0,1
T79,2023,부산,질병,1,0,1
T79,2023,서울,질병,2,1,3
T79,2023,인천,질병,1,0,1
T80,2019,서울,질병,6,5,11
T80,2020,대구,질병,1,0,1
T80,2020,서울,질병,3,3,6
T80,2021,서울,질병,7,3,10
T80,2022,서울,질병,9,6,15
T80,2023,대구,질병,2,0,2
T80,2023,서울,질병,8,7,15
T81,2019,광주,질병,5,5,10
T81,2019,대구,질병,13,3,16
T81,2019,대전,질병,4,6,10
T81,2019,부산,질병,7,5,12
T81,2019,서울,질병,94,72,166
T81,2019,인천,질병,0,2,2
T81,2020,광주,질병,10,3,13
T81,2020,대구,질병,12,1,13
T81,2020,대전,질병,8,2,10
T81,2020,서울,질병,140,114,254
T81,2020,인천,질병,0,1,1
T81,2021,광주,질병,4,3,7
T81,2021,대구,질병,8,2,10
T81,2021,대전,질병,6,2,8
T81,2021,부산,질병,10,2,12
T81,2021,서울,질병,163,112,275
T81,2022,광주,질병,1,2,3
T81,2022,대구,질병,14,4,18
T81,2022,대전,질병,4,7,11
T81,2022,부산,질병,3,0,3
T81,2022,서울,질병,173,129,302
T81,2022,인천,질병,0,1,1
T81,2023,광주,질병,5,3,8
T81,2023,대구,질병,7,6,13
T81,2023,대전,질병,5,7,12
T81,2023,부산,질병,5,2,7
T81,2023,서울,질병,196,133,329
T81,2023,인천,질병,2,3,5
T82,2019,광주,질병,1,0,1
T82,2019,대구,질병,1,1,2
T82,2019,서울,질병,61,30,91
T82,2020,대구,질병,2,0,2
T82,2020,서울,질병,91,38,129
T82,2021,대구,질병,3,1,4
T82,2021,부산,질병,1,0,1
T82,2021,서울,질병,99,41,140
T82,2022,대구,질병,3,2,5
T82,2022,부산,질병,1,0,1
T82,2022,서울,질병,98,34,132
T82,2023,광주,질병,0,1,1
T82,2023,대구,질병,3,3,6
T82,2023,서울,질병,115,46,161
T83,2019,서울,질병,15,16,31
T83,2020,서울,질병,22,22,44
T83,2021,서울,질병,21,9,30
T83,2021,인천,질병,2,0,2
T83,2022,서울,질병,25,17,42
T83,2023,서울,질병,37,15,52
T84,2019,광주,질병,7,4,11
T84,2019,대구,질병,16,12,28
T84,2019,대전,질병,6,8,14
T84,2019,부산,질병,11,3,14
T84,2019,서울,질병,37,52,89
T84,2019,인천,질병,0,2,2
T84,2020,광주,질병,12,4,16
T84,2020,대구,질병,11,9,20
T84,2020,대전,질병,3,1,4
T84,2020,서울,질병,41,47,88
T84,2020,인천,질병,0,5,5
T84,2021,광주,질병,13,3,16
T84,2021,대구,질병,6,1,7
T84,2021,대전,질병,5,2,7
T84,2021,부산,질병,14,0,14
T84,2021,서울,질병,33,56,89
T84,2021,인천,질병,2,0,2
T84,2022,광주,질병,6,3,9
T84,2022,대구,질병,8,3,11
T84,2022,대전,질병,2,0,2
T84,2022,부산,질병,11,1,12
T84,2022,서울,질병,51,49,100
T84,2023,광주,질병,7,2,9
T84,2023,대구,질병,15,6,21
T84,2023,대전,질병,0,1,1
T84,2023,부산,질병,7,3,10
T84,2023,서울,질병,53,42,95
T84,2023,인천,질병,0,1,1
T85,2019,광주,질병,2,0,2
T85,2019,서울,질병,59,38,97
T85,2020,광주,질병,1,0,1
T85,2020,대구,질병,1,0,1
T85,2020,서울,질병,55,21,76
T85,2021,광주,질병,1,0,1
T85,2021,대전,질병,3,0,3
T85,2021,서울,질병,44,31,75
T85,2022,대구,질병,1,0,1
T85,2022,대전,질병,3,0,3
T85,2022,서울,질병,47,27,74
T85,2023,대구,질병,1,0,1
T85,2023,대전,질병,3,0,3
T85,2023,서울,질병,66,26,92
T86,2020,서울,질병,1,2,3
T87,2019,대구,질병,2,0,2
T87,2019,대전,질병,8,0,8
T87,2019,부산,질병,3,0,3
T87,2019,서울,질병,16,0,16
T87,2020,광주,질병,2,0,2
T87,2020,대구,질병,1,0,1
T87,2020,대전,질병,7,0,7
T87,2020,서울,질병,10,1,11
T87,2021,광주,질병,2,0,2
T87,2021,대구,질병,9,0,9
T87,2021,대전,질병,1,0,1
T87,2021,부산,질병,5,0,5
T87,2021,서울,질병,14,1,15
T87,2022,대구,질병,1,0,1
T87,2022,대전,질병,3,0,3
T87,2022,부산,질병,4,1,5
T87,2022,서울,질병,13,2,15
T87,2023,대구,질병,2,0,2
T87,2023,대전,질병,1,0,1
T87,2023,부산,질병,4,2,6
T87,2023,서울,질병,7,2,9
T88,2019,대구,질병,0,2,2
T88,2019,서울,질병,2,3,5
T88,2020,대구,질병,1,0,1
T88,2020,서울,질병,3,4,7
T88,2021,광주,질병,1,0,1
T88,2021,대구,질병,1,1,2
T88,2021,부산,질병,1,0,1
T88,2021,서울,질병,6,4,10
T88,2022,광주,질병,1,0,1
T88,2022,서울,질병,3,5,8
T88,2023,대구,질병,0,1,1
T88,2023,부산,질병,1,0,1
T88,2023,서울,질병,14,3,17
T90,2019,광주,질병,2,0,2
T90,2019,대전,질병,6,0,6
T90,2019,서울,질병,12,14,26
T90,2020,대구,질병,1,0,1
T90,2020,대전,질병,4,0,4
T90,2020,서울,질병,11,6,17
T90,2021,광주,질병,1,0,1
T90,2021,대전,질병,6,1,7
T90,2021,서울,질병,7,1,8
T90,2022,대전,질병,6,1,7
T90,2022,부산,질병,0,1,1
T90,2022,서울,질병,11,0,11
T90,2023,대전,질병,7,0,7
T90,2023,서울,질병,9,4,13
T91,2019,대구,질병,0,7,7
T91,2019,대전,질병,4,0,4
T91,2019,부산,질병,1,1,2
T91,2019,서울,질병,39,16,55
T91,2020,대구,질병,0,2,2
T91,2020,대전,질병,4,0,4
T91,2020,서울,질병,33,26,59
T91,2020,인천,질병,1,3,4
T91,2021,대구,질병,0,1,1
T91,2021,대전,질병,4,0,4
T91,2021,부산,질병,0,2,2
T91,2021,서울,질병,11,0,11
T91,2021,인천,질병,0,3,3
T91,2022,대구,질병,1,0,1
T91,2022,대전,질병,5,0,5
T91,2022,서울,질병,44,15,59
T91,2023,광주,질병,1,0,1
T91,2023,대구,질병,0,2,2
T91,2023,대전,질병,2,1,3
T91,2023,서울,질병,21,18,39
T92,2019,대구,질병,0,1,1
T92,2019,서울,질병,1,0,1
T92,2020,서울,질병,1,0,1
T92,2020,인천,질병,1,1,2
T92,2021,인천,질병,0,1,1
T92,2022,서울,질병,0,3,3
T92,2023,서울,질병,0,1,1
T93,2019,광주,질병,0,1,1
T93,2019,대전,질병,6,0,6
T93,2019,인천,질병,1,0,1
T93,2020,광주,질병,1,0,1
T93,2020,대전,질병,4,0,4
T93,2020,서울,질병,1,1,2
T93,2020,인천,질병,1,4,5
T93,2021,대전,질병,7,0,7
T93,2021,인천,질병,1,6,7
T93,2022,대구,질병,1,0,1
T93,2022,대전,질병,10,0,10
T93,2022,서울,질병,2,0,2
T93,2023,대구,질병,0,1,1
T93,2023,대전,질병,2,0,2
T95,2019,대구,질병,1,0,1
T95,2019,서울,질병,1,0,1
T95,2020,서울,질병,2,0,2
T95,2022,서울,질병,1,0,1
T97,2020,대구,질병,3,0,3
T97,2021,서울,질병,1,0,1
T98,2023,서울,질병,1,0,1
U07,2020,대구,질병,3,208,211
U07,2020,대전,질병,0,173,173
U07,2020,서울,질병,1,58,59
U07,2020,인천,질병,2,0,2
U07,2021,광주,질병,0,475,475
U07,2021,대구,질병,0,801,801
U07,2021,대전,질병,10,1180,1190
U07,2021,부산,질병,8,469,477
U07,2021,서울,질병,40,2759,2799
U07,2021,인천,질병,1,0,1
U07,2022,광주,질병,23,283,306
U07,2022,대구,질병,182,1788,1970
U07,2022,대전,질병,133,572,705
U07,2022,부산,질병,67,622,689
U07,2022,서울,질병,259,1124,1383
U07,2022,인천,질병,3,64,67
U07,2023,대구,질병,147,103,250
U07,2023,대전,질병,66,84,150
U07,2023,부산,질병,34,28,62
U07,2023,서울,질병,266,250,516
U07,2023,인천,질병,0,5,5
U08,2020,서울,질병,0,1,1
U08,2021,서울,질병,5,2,7
U08,2022,대구,질병,32,12,44
U08,2022,대전,질병,18,12,30
U08,2022,서울,질병,291,198,489
U08,2023,대전,질병,3,5,8
U08,2023,서울,질병,496,351,847
U09,2021,서울,질병,3,2,5
U09,2022,광주,질병,1,4,5
U09,2022,대구,질병,21,10,31
U09,2022,대전,질병,1,2,3
U09,2022,서울,질병,25,27,52
U09,2023,대구,질병,12,17,29
U09,2023,부산,질병,2,2,4
U09,2023,서울,질병,16,9,25
U10,2021,서울,질병,0,1,1
U10,2023,서울,질병,1,0,1
U11,2021,대구,질병,1,0,1
U11,2022,광주,질병,1,0,1
U12,2021,광주,질병,0,1,1
U12,2021,대구,질병,0,1,1
U12,2021,서울,질병,2,0,2
U23,2019,대전,질병,2,0,2
U23,2020,대전,질병,4,0,4
U23,2023,대전,질병,2,0,2
U30,2019,대전,질병,2,0,2
U70,2022,부산,질병,2,0,2
U82,2019,대구,질병,10,19,29
U82,2019,부산,질병,4,2,6
U82,2019,서울,질병,364,252,616
U82,2020,광주,질병,1,1,2
U82,2020,대구,질병,75,2,77
U82,2020,대전,질병,0,1,1
U82,2020,서울,질병,426,288,714
U82,2020,인천,질병,0,1,1
U82,2021,대구,질병,16,47,63
U82,2021,대전,질병,0,1,1
U82,2021,부산,질병,2,0,2
U82,2021,서울,질병,279,164,443
U82,2022,대구,질병,53,11,64
U82,2022,대전,질병,3,0,3
U82,2022,서울,질병,299,199,498
U82,2023,대구,질병,34,52,86
U82,2023,대전,질병,6,2,8
U82,2023,부산,질병,5,0,5
U82,2023,서울,질병,319,244,563
U83,2019,대구,질병,4,11,15
U83,2019,부산,질병,1,0,1
U83,2019,서울,질병,147,115,262
U83,2020,대구,질병,22,0,22
U83,2020,서울,질병,169,112,281
U83,2021,대구,질병,3,18,21
U83,2021,서울,질병,99,58,157
U83,2022,대구,질병,19,3,22
U83,2022,서울,질병,77,72,149
U83,2023,대구,질병,6,8,14
U83,2023,서울,질병,122,113,235
U84,2019,서울,질병,1,4,5
U84,2020,서울,질병,0,2,2
U84,2022,광주,질병,0,1,1
U84,2022,서울,질병,1,0,1
U84,2023,서울,질병,1,1,2
U99,2019,대구,질병,8,4,12
U99,2019,대전,질병,2,3,5
U99,2019,서울,질병,145,28,173
U99,2020,대구,질병,18,1,19
U99,2020,대전,질병,1,2,3
U99,2020,서울,질병,146,38,184
U99,2021,대구,질병,9,5,14
U99,2021,대전,질병,2,2,4
U99,2021,서울,질병,123,31,154
U99,2022,대구,질병,13,1,14
U99,2022,대전,질병,5,14,19
U99,2022,서울,질병,77,19,96
U99,2023,대구,질병,15,12,27
U99,2023,대전,질병,4,5,9
U99,2023,서울,질병,154,18,172
V02,2019,서울,질병,0,1,1
V02,2020,서울,질병,0,1,1
V02,2021,대구,질병,0,1,1
V02,2022,부산,질병,0,1,1
V03,2019,대구,질병,0,2,2
V03,2019,부산,질병,0,1,1
V03,2019,서울,질병,0,2,2
V03,2020,대전,질병,0,2,2
V03,2020,서울,질병,0,1,1
V03,2021,대전,질병,0,1,1
V03,2022,대구,질병,1,0,1
V03,2022,부산,질병,0,1,1
V03,2023,대구,질병,0,1,1
V03,2023,부산,질병,1,1,2
V03,2023,서울,질병,1,2,3
V04,2019,서울,질병,0,1,1
V09,2019,대구,질병,0,1,1
V09,2019,대전,질병,0,1,1
V09,2019,부산,질병,0,1,1
V09,2019,서울,질병,0,2,2
V09,2019,인천,질병,0,1,1
V09,2020,대구,질병,0,1,1
V09,2020,서울,질병,0,1,1
V09,2021,대구,질병,0,1,1
V09,2022,대전,질병,0,1,1
V09,2022,서울,질병,2,3,5
V09,2023,대구,질병,0,2,2
V09,2023,부산,질병,0,2,2
V09,2023,서울,질병,2,0,2
V10,2023,대구,질병,0,1,1
V11,2019,대전,질병,1,0,1
V11,2019,서울,질병,1,1,2
V11,2020,대전,질병,1,0,1
V11,2020,서울,질병,0,1,1
V11,2022,서울,질병,1,0,1
V11,2023,서울,질병,0,1,1
V13,2019,대전,질병,0,1,1
V13,2019,서울,질병,0,1,1
V13,2020,서울,질병,0,2,2
V13,2022,대전,질병,1,1,2
V14,2020,서울,질병,0,1,1
V17,2019,서울,질병,1,1,2
V17,2022,대전,질병,0,1,1
V17,2022,서울,질병,1,1,2
V18,2019,대구,질병,4,2,6
V18,2019,대전,질병,3,4,7
V18,2019,서울,질병,4,9,13
V18,2019,인천,질병,0,3,3
V18,2020,대구,질병,6,3,9
V18,2020,대전,질병,1,7,8
V18,2020,서울,질병,15,12,27
V18,2021,대구,질병,4,5,9
V18,2021,대전,질병,3,2,5
V18,2021,부산,질병,0,2,2
V18,2022,대구,질병,4,4,8
V18,2022,대전,질병,6,5,11
V18,2022,부산,질병,1,2,3
V18,2022,서울,질병,5,3,8
V18,2023,대구,질병,2,4,6
V18,2023,대전,질병,4,6,10
V18,2023,부산,질병,1,0,1
V18,2023,서울,질병,5,12,17
V19,2019,서울,질병,0,3,3
V19,2020,대구,질병,1,4,5
V19,2020,서울,질병,0,1,1
V19,2021,대구,질병,4,0,4
V19,2021,대전,질병,0,1,1
V19,2021,부산,질병,1,0,1
V19,2022,대구,질병,1,1,2
V19,2022,대전,질병,0,1,1
V19,2022,서울,질병,1,1,2
V19,2023,대구,질병,2,0,2
V19,2023,대전,질병,0,1,1
V22,2019,대구,질병,1,0,1
V22,2020,서울,질병,0,1,1
V23,2019,대구,질병,0,1,1
V23,2019,서울,질병,0,2,2
V23,2020,대구,질병,0,1,1
V23,2020,서울,질병,1,4,5
V23,2021,대구,질병,0,1,1
V23,2021,부산,질병,0,1,1
V23,2022,서울,질병,0,1,1
V23,2023,대전,질병,1,0,1
V23,2023,서울,질병,0,2,2
V27,2022,서울,질병,0,1,1
V28,2019,대구,질병,0,1,1
V28,2019,대전,질병,2,2,4
V28,2019,서울,질병,1,4,5
V28,2020,대전,질병,0,2,2
V28,2020,서울,질병,2,4,6
V28,2021,대전,질병,2,1,3
V28,2021,부산,질병,2,0,2
V28,2022,대구,질병,2,0,2
V28,2022,대전,질병,2,0,2
V28,2022,서울,질병,4,2,6
V28,2023,대전,질병,0,1,1
V28,2023,부산,질병,0,1,1
V28,2023,서울,질병,1,2,3
V29,2019,대구,질병,1,0,1
V29,2019,대전,질병,1,1,2
V29,2019,서울,질병,1,0,1
V29,2020,대구,질병,0,3,3
V29,2020,대전,질병,0,1,1
V29,2021,대구,질병,4,1,5
V29,2021,대전,질병,2,2,4
V29,2023,대구,질병,3,2,5
V29,2023,대전,질병,1,1,2
V29,2023,서울,질병,1,0,1
V33,2020,대전,질병,1,0,1
V38,2021,대전,질병,0,1,1
V38,2021,부산,질병,1,0,1
V38,2023,대전,질병,1,0,1
V39,2019,대전,질병,1,0,1
V39,2020,대전,질병,0,1,1
V42,2019,대전,질병,0,1,1
V42,2019,서울,질병,0,1,1
V43,2019,대구,질병,0,1,1
V43,2019,대전,질병,0,4,4
V43,2019,서울,질병,0,1,1
V43,2020,대전,질병,1,2,3
V43,2020,서울,질병,0,2,2
V43,2021,대전,질병,0,2,2
V43,2022,대전,질병,0,1,1
V43,2022,서울,질병,0,2,2
V43,2023,부산,질병,0,1,1
V43,2023,서울,질병,1,0,1
V44,2019,서울,질병,0,1,1
V44,2020,대전,질병,0,1,1
V44,2021,대전,질병,0,2,2
V44,2023,서울,질병,1,0,1
V47,2019,대구,질병,0,1,1
V47,2019,대전,질병,0,1,1
V47,2020,대전,질병,1,2,3
V47,2021,대구,질병,0,2,2
V47,2021,대전,질병,0,2,2
V48,2019,대전,질병,0,2,2
V48,2019,서울,질병,2,1,3
V48,2020,대전,질병,0,1,1
V48,2020,서울,질병,5,1,6
V48,2021,대전,질병,2,0,2
V48,2021,부산,질병,1,0,1
V48,2022,서울,질병,0,1,1
V48,2023,서울,질병,1,2,3
V49,2019,대구,질병,0,1,1
V49,2019,대전,질병,0,3,3
V49,2019,서울,질병,1,0,1
V49,2020,대전,질병,1,1,2
V49,2020,서울,질병,0,3,3
V49,2021,대구,질병,0,3,3
V49,2021,대전,질병,0,2,2
V49,2022,대구,질병,1,0,1
V49,2022,대전,질병,0,3,3
V49,2022,부산,질병,0,1,1
V49,2022,서울,질병,0,2,2
V49,2023,대전,질병,1,2,3
V49,2023,서울,질병,2,1,3
V53,2023,대전,질병,0,1,1
V54,2019,서울,질병,0,2,2
V57,2023,대전,질병,0,1,1
V58,2019,대전,질병,0,1,1
V58,2019,서울,질병,1,0,1
V58,2023,대전,질병,0,1,1
V58,2023,서울,질병,0,2,2
V59,2020,대전,질병,1,0,1
V59,2022,대전,질병,0,2,2
V59,2022,서울,질병,0,1,1
V59,2023,대전,질병,0,1,1
V61,2023,서울,질병,0,1,1
V69,2019,대전,질병,0,1,1
V69,2022,대전,질병,1,1,2
V69,2022,부산,질병,0,1,1
V78,2019,대구,질병,0,1,1
V78,2019,대전,질병,1,0,1
V78,2019,부산,질병,1,0,1
V78,2019,서울,질병,0,2,2
V78,2019,인천,질병,1,0,1
V78,2020,대전,질병,1,0,1
V78,2020,서울,질병,2,1,3
V78,2021,대구,질병,0,1,1
V78,2021,부산,질병,1,0,1
V78,2022,대구,질병,2,0,2
V78,2022,서울,질병,0,1,1
V78,2023,서울,질병,1,2,3
V79,2019,대구,질병,1,1,2
V79,2020,대구,질병,1,1,2
V79,2020,대전,질병,0,2,2
V79,2021,대전,질병,1,1,2
V79,2022,대전,질병,0,2,2
V79,2022,서울,질병,1,3,4
V79,2023,대전,질병,0,2,2
V79,2023,서울,질병,2,1,3
V80,2019,서울,질병,0,1,1
V81,2019,서울,질병,0,1,1
V81,2023,대구,질병,0,1,1
V81,2023,서울,질병,1,1,2
V83,2020,대전,질병,1,0,1
V83,2023,대구,질병,0,1,1
V84,2019,대구,질병,2,0,2
V84,2019,대전,질병,6,1,7
V84,2019,서울,질병,1,2,3
V84,2020,대구,질병,1,0,1
V84,2020,대전,질병,1,1,2
V84,2020,서울,질병,0,1,1
V84,2021,대구,질병,1,1,2
V84,2021,대전,질병,0,1,1
V84,2022,대구,질병,2,0,2
V84,2022,대전,질병,2,2,4
V84,2022,서울,질병,1,0,1
V84,2023,대구,질병,1,1,2
V84,2023,대전,질병,1,0,1
V88,2019,대전,질병,2,2,4
V88,2019,서울,질병,1,0,1
V88,2021,대구,질병,1,0,1
V89,2019,대전,질병,0,1,1
V89,2020,대구,질병,1,0,1
V89,2020,대전,질병,2,0,2
V89,2021,대전,질병,1,1,2
V89,2022,대전,질병,0,2,2
V89,2022,서울,질병,0,3,3
V89,2023,대구,질병,0,1,1
V89,2023,대전,질병,1,2,3
V89,2023,서울,질병,0,2,2
V98,2019,대구,질병,0,1,1
V98,2022,대구,질병,2,0,2
V98,2023,대구,질병,2,0,2
V99,2019,대구,질병,1,4,5
V99,2019,서울,질병,1,0,1
V99,2020,대구,질병,1,2,3
V99,2020,서울,질병,1,1,2
V99,2021,대구,질병,0,2,2
V99,2022,대구,질병,7,0,7
V99,2022,대전,질병,0,2,2
V99,2023,대구,질병,1,2,3
W00,2019,대구,질병,2,2,4
W00,2019,대전,질병,3,1,4
W00,2019,서울,질병,2,2,4
W00,2020,대전,질병,1,0,1
W00,2020,서울,질병,3,1,4
W00,2021,대전,질병,2,0,2
W00,2022,대전,질병,0,1,1
W00,2022,서울,질병,1,3,4
W00,2023,대구,질병,1,1,2
W00,2023,대전,질병,1,2,3
W00,2023,서울,질병,5,11,16
W01,2019,대구,질병,58,84,142
W01,2019,대전,질병,25,72,97
W01,2019,부산,질병,9,2,11
W01,2019,서울,질병,84,128,212
W01,2019,인천,질병,4,5,9
W01,2020,대구,질병,13,85,98
W01,2020,대전,질병,29,51,80
W01,2020,서울,질병,66,142,208
W01,2021,대구,질병,44,6,50
W01,2021,대전,질병,28,39,67
W01,2021,부산,질병,23,52,75
W01,2022,대구,질병,15,67,82
W01,2022,대전,질병,35,69,104
W01,2022,부산,질병,12,52,64
W01,2022,서울,질병,26,70,96
W01,2023,대구,질병,52,16,68
W01,2023,대전,질병,64,124,188
W01,2023,부산,질병,8,45,53
W01,2023,서울,질병,36,80,116
W02,2019,서울,질병,0,1,1
W02,2020,대구,질병,0,1,1
W02,2020,대전,질병,0,1,1
W02,2022,대구,질병,1,0,1
W02,2023,서울,질병,0,2,2
W03,2019,대전,질병,0,1,1
W03,2020,서울,질병,1,0,1
W03,2022,대구,질병,1,0,1
W03,2022,대전,질병,0,1,1
W03,2022,서울,질병,1,0,1
W03,2023,대구,질병,0,1,1
W03,2023,서울,질병,0,1,1
W04,2019,대전,질병,1,0,1
W04,2020,대전,질병,0,1,1
W04,2023,서울,질병,0,1,1
W05,2019,서울,질병,6,6,12
W05,2020,대구,질병,0,1,1
W05,2020,대전,질병,0,2,2
W05,2020,서울,질병,6,4,10
W05,2021,대구,질병,5,0,5
W05,2021,대전,질병,1,1,2
W05,2022,대구,질병,2,0,2
W05,2022,대전,질병,2,2,4
W05,2022,서울,질병,1,0,1
W05,2023,대구,질병,1,1,2
W05,2023,대전,질병,1,1,2
W05,2023,서울,질병,4,0,4
W06,2019,대구,질병,8,9,17
W06,2019,대전,질병,7,4,11
W06,2019,서울,질병,22,30,52
W06,2019,인천,질병,0,1,1
W06,2020,대구,질병,5,7,12
W06,2020,대전,질병,5,1,6
W06,2020,서울,질병,21,28,49
W06,2021,대구,질병,6,11,17
W06,2021,대전,질병,4,7,11
W06,2021,부산,질병,2,0,2
W06,2022,대구,질병,7,6,13
W06,2022,대전,질병,6,15,21
W06,2022,부산,질병,2,0,2
W06,2022,서울,질병,17,30,47
W06,2023,대구,질병,9,1,10
W06,2023,대전,질병,3,6,9
W06,2023,서울,질병,28,33,61
W07,2019,대구,질병,4,2,6
W07,2019,대전,질병,2,4,6
W07,2019,서울,질병,11,15,26
W07,2019,인천,질병,0,1,1
W07,2020,대구,질병,0,2,2
W07,2020,대전,질병,2,4,6
W07,2020,서울,질병,4,15,19
W07,2021,대구,질병,1,1,2
W07,2021,대전,질병,2,4,6
W07,2022,대구,질병,2,0,2
W07,2022,대전,질병,1,4,5
W07,2022,서울,질병,7,5,12
W07,2023,대구,질병,1,1,2
W07,2023,대전,질병,1,4,5
W07,2023,서울,질병,6,19,25
W08,2019,대구,질병,0,1,1
W08,2019,대전,질병,1,0,1
W08,2019,서울,질병,0,3,3
W08,2023,서울,질병,1,3,4
W09,2020,대구,질병,2,0,2
W09,2020,서울,질병,0,6,6
W09,2021,대전,질병,1,1,2
W09,2021,부산,질병,1,0,1
W09,2022,대전,질병,0,1,1
W09,2022,서울,질병,4,2,6
W09,2023,대구,질병,1,0,1
W09,2023,서울,질병,2,3,5
W10,2019,대구,질병,10,11,21
W10,2019,대전,질병,6,13,19
W10,2019,부산,질병,0,1,1
W10,2019,서울,질병,23,38,61
W10,2019,인천,질병,1,1,2
W10,2020,대구,질병,8,6,14
W10,2020,대전,질병,5,12,17
W10,2020,서울,질병,21,33,54
W10,2021,대구,질병,9,6,15
W10,2021,대전,질병,8,8,16
W10,2021,부산,질병,11,0,11
W10,2022,대구,질병,14,6,20
W10,2022,대전,질병,5,12,17
W10,2022,부산,질병,4,0,4
W10,2022,서울,질병,19,34,53
W10,2023,대구,질병,8,5,13
W10,2023,대전,질병,9,11,20
W10,2023,부산,질병,2,0,2
W10,2023,서울,질병,21,39,60
W11,2019,대구,질병,4,0,4
W11,2019,대전,질병,6,4,10
W11,2019,부산,질병,2,0,2
W11,2019,서울,질병,3,8,11
W11,2020,대구,질병,3,1,4
W11,2020,대전,질병,2,2,4
W11,2020,서울,질병,3,0,3
W11,2021,대구,질병,1,6,7
W11,2021,대전,질병,0,2,2
W11,2021,부산,질병,2,1,3
W11,2022,대구,질병,3,1,4
W11,2022,대전,질병,6,2,8
W11,2022,부산,질병,0,2,2
W11,2022,서울,질병,1,2,3
W11,2023,대구,질병,3,3,6
W11,2023,대전,질병,1,0,1
W11,2023,부산,질병,1,0,1
W11,2023,서울,질병,2,3,5
W12,2019,인천,질병,0,1,1
W12,2020,서울,질병,0,2,2
W12,2022,대전,질병,0,1,1
W13,2019,대구,질병,2,1,3
W13,2019,대전,질병,0,1,1
W13,2019,서울,질병,0,3,3
W13,2020,대구,질병,1,2,3
W13,2020,서울,질병,0,7,7
W13,2022,대구,질병,1,0,1
W13,2023,대구,질병,1,0,1
W13,2023,대전,질병,1,0,1
W13,2023,서울,질병,1,2,3
W14,2019,대구,질병,1,1,2
W14,2019,대전,질병,0,2,2
W14,2019,서울,질병,2,0,2
W14,2020,대구,질병,1,0,1
W14,2020,대전,질병,0,1,1
W14,2020,서울,질병,2,1,3
W14,2021,대구,질병,0,1,1
W14,2021,대전,질병,1,1,2
W14,2021,부산,질병,1,0,1
W14,2022,대구,질병,2,0,2
W14,2022,대전,질병,1,0,1
W14,2022,서울,질병,0,1,1
W14,2023,대전,질병,1,1,2
W14,2023,부산,질병,1,0,1
W14,2023,서울,질병,1,0,1
W15,2019,인천,질병,0,1,1
W15,2020,서울,질병,0,2,2
W15,2021,부산,질병,2,0,2
W17,2019,대구,질병,2,4,6
W17,2019,대전,질병,7,2,9
W17,2019,부산,질병,3,1,4
W17,2019,서울,질병,2,1,3
W17,2019,인천,질병,0,3,3
W17,2020,대구,질병,6,0,6
W17,2020,대전,질병,2,2,4
W17,2020,서울,질병,0,1,1
W17,2021,대구,질병,3,4,7
W17,2021,대전,질병,4,5,9
W17,2021,부산,질병,3,1,4
W17,2022,대구,질병,6,1,7
W17,2022,대전,질병,6,2,8
W17,2022,부산,질병,1,1,2
W17,2022,서울,질병,4,2,6
W17,2023,대구,질병,2,1,3
W17,2023,대전,질병,0,1,1
W17,2023,부산,질병,1,0,1
W17,2023,서울,질병,4,3,7
W18,2019,대구,질병,13,9,22
W18,2019,대전,질병,24,51,75
W18,2019,부산,질병,27,30,57
W18,2019,서울,질병,57,103,160
W18,2019,인천,질병,2,5,7
W18,2020,대구,질병,10,10,20
W18,2020,대전,질병,34,46,80
W18,2020,서울,질병,61,94,155
W18,2021,대구,질병,1,27,28
W18,2021,대전,질병,42,42,84
W18,2021,부산,질병,18,1,19
W18,2022,대구,질병,7,6,13
W18,2022,대전,질병,16,31,47
W18,2022,부산,질병,18,0,18
W18,2022,서울,질병,84,137,221
W18,2023,대구,질병,17,21,38
W18,2023,대전,질병,11,22,33
W18,2023,부산,질병,10,0,10
W18,2023,서울,질병,110,178,288
W19,2019,대구,질병,40,64,104
W19,2019,대전,질병,2,1,3
W19,2019,서울,질병,11,21,32
W19,2019,인천,질병,0,2,2
W19,2020,대구,질병,83,38,121
W19,2020,대전,질병,2,1,3
W19,2020,서울,질병,12,16,28
W19,2021,대구,질병,55,111,166
W19,2021,대전,질병,0,1,1
W19,2021,부산,질병,6,0,6
W19,2022,대구,질병,75,23,98
W19,2022,대전,질병,2,6,8
W19,2022,부산,질병,3,0,3
W19,2022,서울,질병,30,29,59
W19,2023,대구,질병,32,69,101
W19,2023,대전,질병,1,3,4
W19,2023,부산,질병,3,0,3
W19,2023,서울,질병,16,24,40
W20,2019,대구,질병,1,1,2
W20,2019,대전,질병,1,2,3
W20,2019,서울,질병,2,2,4
W20,2019,인천,질병,1,0,1
W20,2020,대구,질병,1,2,3
W20,2020,대전,질병,2,1,3
W20,2020,서울,질병,3,2,5
W20,2021,대구,질병,0,1,1
W20,2021,대전,질병,1,0,1
W20,2022,대구,질병,2,0,2
W20,2022,서울,질병,2,2,4
W20,2023,대구,질병,3,1,4
W20,2023,서울,질병,2,2,4
W21,2019,서울,질병,1,0,1
W21,2019,인천,질병,0,1,1
W21,2020,서울,질병,1,0,1
W21,2023,대전,질병,0,1,1
W21,2023,서울,질병,3,0,3
W22,2019,대구,질병,4,2,6
W22,2019,대전,질병,5,2,7
W22,2019,서울,질병,8,6,14
W22,2020,대구,질병,7,2,9
W22,2020,대전,질병,0,1,1
W22,2020,서울,질병,4,7,11
W22,2021,대구,질병,11,2,13
W22,2021,대전,질병,3,3,6
W22,2022,대구,질병,4,5,9
W22,2022,대전,질병,2,4,6
W22,2022,서울,질병,3,5,8
W22,2023,대구,질병,2,3,5
W22,2023,대전,질병,3,3,6
W22,2023,부산,질병,1,0,1
W22,2023,서울,질병,16,5,21
W23,2019,대전,질병,2,1,3
W23,2019,서울,질병,3,1,4
W23,2020,대구,질병,1,1,2
W23,2020,서울,질병,2,5,7
W23,2021,대구,질병,0,2,2
W23,2021,대전,질병,0,2,2
W23,2022,대구,질병,1,0,1
W23,2022,대전,질병,1,0,1
W23,2022,서울,질병,1,1,2
W23,2023,대구,질병,0,1,1
W23,2023,서울,질병,1,2,3
W25,2019,대전,질병,0,1,1
W25,2019,서울,질병,1,0,1
W25,2020,대구,질병,0,1,1
W25,2020,서울,질병,0,1,1
W25,2021,대구,질병,1,0,1
W26,2019,서울,질병,3,3,6
W26,2020,대전,질병,2,1,3
W26,2020,서울,질병,1,0,1
W26,2022,대전,질병,1,2,3
W26,2023,대구,질병,2,0,2
W27,2019,대구,질병,0,2,2
W27,2019,서울,질병,0,1,1
W27,2020,대구,질병,1,1,2
W27,2020,대전,질병,1,0,1
W27,2021,대전,질병,1,0,1
W27,2022,대구,질병,3,0,3
W27,2022,서울,질병,2,0,2
W27,2023,대구,질병,1,0,1
W28,2019,대전,질병,2,0,2
W28,2019,서울,질병,1,0,1
W29,2019,대구,질병,3,0,3
W29,2019,대전,질병,0,1,1
W29,2019,서울,질병,0,3,3
W29,2020,대구,질병,1,0,1
W29,2020,대전,질병,0,2,2
W29,2020,서울,질병,0,2,2
W29,2021,대구,질병,2,0,2
W29,2022,대구,질병,1,0,1
W29,2022,대전,질병,2,0,2
W29,2022,서울,질병,0,3,3
W29,2023,대전,질병,2,0,2
W30,2019,대구,질병,2,0,2
W30,2019,대전,질병,1,0,1
W30,2019,서울,질병,0,1,1
W30,2020,서울,질병,1,0,1
W30,2021,대전,질병,1,0,1
W30,2021,부산,질병,1,0,1
W30,2022,대전,질병,1,0,1
W30,2023,대전,질병,1,0,1
W31,2019,대구,질병,1,2,3
W31,2019,대전,질병,0,1,1
W31,2019,부산,질병,1,0,1
W31,2019,서울,질병,0,1,1
W31,2020,서울,질병,1,0,1
W31,2021,대구,질병,0,1,1
W31,2022,서울,질병,0,1,1
W31,2023,대전,질병,0,2,2
W40,2019,서울,질병,0,1,1
W44,2019,대전,질병,1,1,2
W44,2019,서울,질병,6,2,8
W44,2020,서울,질병,5,1,6
W44,2022,서울,질병,5,2,7
W44,2023,서울,질병,1,3,4
W45,2019,대전,질병,1,0,1
W45,2019,서울,질병,2,0,2
W45,2020,광주,질병,1,0,1
W45,2022,서울,질병,1,0,1
W45,2023,서울,질병,1,0,1
W46,2020,대구,질병,1,0,1
W49,2019,서울,질병,0,3,3
W49,2021,대구,질병,0,1,1
W50,2019,서울,질병,1,1,2
W50,2020,대전,질병,1,0,1
W50,2020,서울,질병,1,3,4
W50,2022,서울,질병,1,1,2
W51,2019,대전,질병,0,1,1
W51,2019,서울,질병,1,0,1
W51,2020,대전,질병,1,0,1
W51,2020,서울,질병,0,1,1
W51,2022,대구,질병,2,0,2
W51,2023,대전,질병,0,1,1
W52,2019,서울,질병,0,1,1
W54,2019,서울,질병,1,0,1
W54,2021,대구,질병,1,0,1
W54,2022,대구,질병,1,0,1
W54,2022,대전,질병,1,0,1
W54,2023,대구,질병,0,2,2
W54,2023,서울,질병,1,0,1
W55,2022,대구,질병,1,0,1
W55,2023,대구,질병,1,0,1
W57,2020,서울,질병,1,0,1
W60,2019,부산,질병,1,0,1
W64,2019,서울,질병,4,2,6
W64,2020,대전,질병,0,1,1
W64,2020,서울,질병,1,2,3
W64,2022,서울,질병,12,10,22
W64,2023,대구,질병,1,1,2
W64,2023,서울,질병,4,9,13
W78,2022,서울,질병,1,0,1
W78,2023,서울,질병,1,2,3
W79,2019,서울,질병,2,0,2
W79,2020,대전,질병,1,1,2
W79,2020,서울,질병,4,5,9
W79,2021,대구,질병,1,0,1
W79,2022,대전,질병,1,0,1
W79,2022,서울,질병,2,1,3
W79,2023,서울,질병,2,1,3
W80,2019,서울,질병,3,1,4
W80,2020,서울,질병,1,0,1
W80,2021,대전,질병,1,0,1
W80,2022,서울,질병,1,0,1
W80,2023,서울,질병,0,1,1
W99,2022,대구,질병,1,0,1
X00,2022,대구,질병,1,0,1
X02,2020,서울,질병,1,0,1
X06,2023,서울,질병,0,1,1
X08,2019,대전,질병,1,0,1
X08,2023,대구,질병,0,1,1
X09,2019,서울,질병,1,0,1
X10,2019,대구,질병,1,0,1
X10,2019,부산,질병,0,1,1
X10,2020,대구,질병,0,1,1
X10,2021,대구,질병,1,0,1
X10,2022,대전,질병,1,0,1
X10,2022,서울,질병,0,1,1
X10,2023,서울,질병,0,1,1
X11,2019,대구,질병,1,0,1
X11,2019,부산,질병,1,0,1
X11,2020,서울,질병,1,0,1
X11,2022,대전,질병,1,0,1
X11,2023,대구,질병,1,0,1
X11,2023,대전,질병,0,1,1
X11,2023,서울,질병,3,0,3
X12,2019,대구,질병,1,0,1
X12,2019,대전,질병,1,0,1
X12,2020,대구,질병,1,0,1
X12,2022,대구,질병,1,0,1
X12,2023,서울,질병,2,0,2
X13,2019,대구,질병,1,0,1
X15,2019,대전,질병,1,0,1
X15,2020,서울,질병,0,1,1
X15,2023,서울,질병,1,0,1
X16,2019,서울,질병,1,1,2
X16,2020,대구,질병,1,1,2
X16,2020,대전,질병,1,0,1
X16,2020,서울,질병,3,2,5
X16,2021,대전,질병,1,1,2
X16,2022,대구,질병,1,0,1
X16,2022,서울,질병,2,1,3
X16,2023,서울,질병,1,1,2
X17,2022,서울,질병,1,0,1
X18,2019,서울,질병,1,0,1
X19,2019,대구,질병,0,1,1
X19,2019,서울,질병,1,0,1
X19,2020,대구,질병,2,1,3
X19,2022,대전,질병,1,0,1
X19,2022,서울,질병,0,1,1
X19,2023,대전,질병,0,1,1
X19,2023,서울,질병,2,1,3
X20,2021,대전,질병,0,1,1
X20,2022,대전,질병,0,3,3
X23,2019,서울,질병,1,0,1
X27,2019,대전,질병,0,1,1
X30,2023,서울,질병,0,1,1
X31,2022,서울,질병,1,0,1
X32,2022,대전,질병,0,1,1
X40,2020,서울,질병,1,0,1
X41,2022,서울,질병,0,1,1
X41,2023,대구,질병,0,1,1
X42,2023,서울,질병,1,1,2
X44,2020,서울,질병,1,1,2
X44,2022,서울,질병,0,1,1
X48,2022,대구,질병,1,0,1
X49,2019,서울,질병,0,1,1
X49,2020,서울,질병,0,1,1
X49,2022,서울,질병,0,1,1
X50,2019,대구,질병,7,13,20
X50,2019,대전,질병,8,17,25
X50,2019,서울,질병,7,2,9
X50,2020,대구,질병,9,5,14
X50,2020,대전,질병,13,11,24
X50,2020,서울,질병,3,7,10
X50,2021,대구,질병,12,11,23
X50,2021,대전,질병,6,3,9
X50,2022,대구,질병,5,4,9
X50,2022,대전,질병,7,14,21
X50,2022,서울,질병,6,16,22
X50,2023,대구,질병,10,8,18
X50,2023,대전,질병,12,16,28
X50,2023,서울,질병,19,26,45
X58,2019,대구,질병,0,2,2
X58,2021,대구,질병,1,6,7
X58,2022,대구,질병,5,0,5
X58,2022,대전,질병,0,1,1
X58,2022,서울,질병,1,1,2
X58,2023,대구,질병,2,0,2
X58,2023,서울,질병,2,1,3
X59,2019,대구,질병,9,6,15
X59,2019,대전,질병,11,22,33
X59,2019,서울,질병,8,3,11
X59,2020,대구,질병,5,18,23
X59,2020,대전,질병,10,12,22
X59,2020,서울,질병,17,21,38
X59,2021,대구,질병,23,11,34
X59,2021,대전,질병,12,13,25
X59,2022,대구,질병,26,26,52
X59,2022,대전,질병,24,22,46
X59,2022,서울,질병,29,28,57
X59,2023,대구,질병,33,44,77
X59,2023,대전,질병,17,26,43
X59,2023,서울,질병,20,18,38
X61,2020,서울,질병,1,2,3
X61,2022,대구,질병,1,0,1
X61,2022,서울,질병,2,1,3
X61,2023,서울,질병,1,1,2
X63,2023,서울,질병,0,1,1
X64,2020,서울,질병,1,0,1
X64,2023,대구,질병,0,1,1
X64,2023,서울,질병,0,2,2
X65,2023,서울,질병,0,1,1
X69,2019,서울,질병,1,0,1
X70,2019,서울,질병,1,0,1
X70,2023,서울,질병,0,2,2
X78,2019,대전,질병,0,1,1
X79,2020,서울,질병,1,0,1
X80,2019,서울,질병,1,0,1
X80,2020,대전,질병,0,1,1
X83,2020,대구,질병,1,0,1
X83,2020,대전,질병,1,0,1
X83,2020,서울,질병,0,1,1
X99,2022,대전,질병,0,1,1
Y04,2019,부산,질병,1,0,1
Y04,2020,대전,질병,0,1,1
Y04,2020,서울,질병,0,1,1
Y04,2022,서울,질병,0,4,4
Y04,2023,서울,질병,1,0,1
Y07,2023,서울,질병,0,1,1
Y12,2022,서울,질병,1,0,1
Y19,2020,대구,질병,1,0,1
Y19,2021,대구,질병,1,0,1
Y19,2021,서울,질병,0,1,1
Y26,2020,대전,질병,1,0,1
Y29,2020,서울,질병,1,0,1
Y30,2023,서울,질병,1,0,1
Y35,2022,서울,질병,3,0,3
Y36,2021,대전,질병,1,0,1
Y40,2019,서울,질병,20,18,38
Y40,2020,서울,질병,159,134,293
Y40,2021,서울,질병,23,16,39
Y40,2022,서울,질병,48,47,95
Y40,2023,대구,질병,0,1,1
Y40,2023,서울,질병,42,42,84
Y41,2019,서울,질병,1,3,4
Y41,2020,서울,질병,7,1,8
Y41,2021,서울,질병,2,3,5
Y41,2022,서울,질병,9,3,12
Y41,2023,서울,질병,3,5,8
Y42,2019,서울,질병,3,1,4
Y42,2020,서울,질병,3,5,8
Y42,2021,서울,질병,0,8,8
Y42,2022,서울,질병,7,3,10
Y42,2023,서울,질병,5,4,9
Y43,2019,대구,질병,0,1,1
Y43,2019,서울,질병,53,17,70
Y43,2020,대구,질병,1,0,1
Y43,2020,서울,질병,87,56,143
Y43,2021,서울,질병,75,30,105
Y43,2022,서울,질병,42,35,77
Y43,2023,대구,질병,0,1,1
Y43,2023,서울,질병,94,28,122
Y44,2019,대구,질병,1,0,1
Y44,2019,서울,질병,7,5,12
Y44,2019,인천,질병,0,1,1
Y44,2020,대전,질병,1,0,1
Y44,2020,서울,질병,4,10,14
Y44,2021,서울,질병,10,8,18
Y44,2022,대구,질병,1,0,1
Y44,2022,대전,질병,1,0,1
Y44,2022,서울,질병,11,4,15
Y44,2023,서울,질병,6,7,13
Y45,2019,서울,질병,6,2,8
Y45,2020,서울,질병,18,11,29
Y45,2021,대구,질병,1,0,1
Y45,2021,서울,질병,6,5,11
Y45,2022,서울,질병,10,10,20
Y45,2023,대전,질병,1,0,1
Y45,2023,서울,질병,10,5,15
Y46,2019,서울,질병,1,0,1
Y46,2020,서울,질병,1,2,3
Y46,2021,서울,질병,3,2,5
Y46,2022,서울,질병,6,0,6
Y46,2023,서울,질병,5,5,10
Y47,2019,서울,질병,2,1,3
Y47,2020,서울,질병,2,2,4
Y47,2021,서울,질병,2,1,3
Y47,2022,서울,질병,2,1,3
Y47,2023,서울,질병,3,2,5
Y48,2019,서울,질병,1,0,1
Y48,2022,서울,질병,0,2,2
Y48,2023,서울,질병,1,1,2
Y49,2019,서울,질병,3,0,3
Y49,2020,서울,질병,1,1,2
Y49,2021,서울,질병,2,3,5
Y49,2022,서울,질병,3,3,6
Y49,2023,서울,질병,3,0,3
Y50,2023,서울,질병,0,2,2
Y51,2019,서울,질병,2,1,3
Y51,2020,서울,질병,4,1,5
Y51,2021,서울,질병,6,2,8
Y51,2022,서울,질병,1,5,6
Y51,2023,서울,질병,3,3,6
Y52,2019,서울,질병,4,5,9
Y52,2020,서울,질병,13,6,19
Y52,2021,대구,질병,1,0,1
Y52,2021,서울,질병,9,3,12
Y52,2022,서울,질병,9,7,16
Y52,2023,대구,질병,1,0,1
Y52,2023,서울,질병,11,4,15
Y53,2019,서울,질병,0,1,1
Y53,2020,서울,질병,2,0,2
Y53,2021,서울,질병,2,1,3
Y53,2022,서울,질병,1,0,1
Y53,2023,서울,질병,3,0,3
Y54,2019,서울,질병,2,2,4
Y54,2020,대구,질병,1,0,1
Y54,2020,서울,질병,9,3,12
Y54,2021,서울,질병,2,2,4
Y54,2022,서울,질병,5,8,13
Y54,2023,서울,질병,6,2,8
Y55,2019,서울,질병,0,1,1
Y55,2020,서울,질병,1,0,1
Y55,2021,서울,질병,1,0,1
Y55,2023,서울,질병,3,0,3
Y56,2019,서울,질병,1,0,1
Y56,2020,서울,질병,0,1,1
Y56,2021,서울,질병,1,1,2
Y56,2022,서울,질병,0,2,2
Y56,2023,서울,질병,0,1,1
Y57,2019,대구,질병,3,1,4
Y57,2019,서울,질병,4,6,10
Y57,2020,대구,질병,3,0,3
Y57,2020,서울,질병,8,1,9
Y57,2021,서울,질병,11,5,16
Y57,2022,대구,질병,1,0,1
Y57,2022,서울,질병,7,7,14
Y57,2023,대구,질병,0,4,4
Y57,2023,서울,질병,13,3,16
Y59,2019,서울,질병,2,0,2
Y59,2020,서울,질병,2,1,3
Y59,2021,대구,질병,0,1,1
Y59,2021,서울,질병,2,0,2
Y59,2023,대구,질병,0,1,1
Y60,2019,대구,질병,3,1,4
Y60,2019,대전,질병,0,2,2
Y60,2019,서울,질병,29,34,63
Y60,2020,대구,질병,2,0,2
Y60,2020,대전,질병,0,1,1
Y60,2020,서울,질병,34,34,68
Y60,2021,대구,질병,1,0,1
Y60,2021,서울,질병,45,41,86
Y60,2022,대구,질병,2,0,2
Y60,2022,서울,질병,48,67,115
Y60,2023,대구,질병,2,9,11
Y60,2023,대전,질병,1,0,1
Y60,2023,서울,질병,57,63,120
Y61,2019,서울,질병,3,0,3
Y61,2020,대구,질병,2,0,2
Y61,2020,대전,질병,1,0,1
Y61,2020,서울,질병,4,0,4
Y61,2021,서울,질병,3,2,5
Y61,2022,서울,질병,0,1,1
Y61,2023,서울,질병,0,1,1
Y62,2020,서울,질병,1,0,1
Y63,2020,서울,질병,1,0,1
Y63,2021,서울,질병,1,0,1
Y63,2023,서울,질병,0,1,1
Y65,2019,서울,질병,1,1,2
Y65,2020,대구,질병,1,0,1
Y65,2020,서울,질병,1,1,2
Y65,2021,대전,질병,1,0,1
Y65,2021,서울,질병,1,1,2
Y65,2022,서울,질병,5,3,8
Y65,2023,서울,질병,5,5,10
Y66,2022,서울,질병,0,1,1
Y75,2022,서울,질병,1,0,1
Y79,2022,광주,질병,1,0,1
Y82,2019,서울,질병,1,0,1
Y83,2019,대구,질병,27,17,44
Y83,2019,대전,질병,4,5,9
Y83,2019,서울,질병,229,134,363
Y83,2020,대구,질병,21,7,28
Y83,2020,대전,질병,10,1,11
Y83,2020,서울,질병,264,176,440
Y83,2021,대구,질병,19,4,23
Y83,2021,대전,질병,7,2,9
Y83,2021,서울,질병,295,201,496
Y83,2022,광주,질병,2,0,2
Y83,2022,대구,질병,17,8,25
Y83,2022,대전,질병,5,2,7
Y83,2022,서울,질병,353,205,558
Y83,2023,대구,질병,26,13,39
Y83,2023,대전,질병,1,0,1
Y83,2023,부산,질병,0,1,1
Y83,2023,서울,질병,394,198,592
Y84,2019,대전,질병,0,1,1
Y84,2019,서울,질병,81,57,138
Y84,2020,대구,질병,1,0,1
Y84,2020,서울,질병,116,56,172
Y84,2021,대구,질병,1,2,3
Y84,2021,서울,질병,102,50,152
Y84,2022,대구,질병,3,1,4
Y84,2022,서울,질병,124,59,183
Y84,2023,대구,질병,1,1,2
Y84,2023,서울,질병,146,68,214
Y85,2019,대구,질병,0,2,2
Y85,2019,서울,질병,9,5,14
Y85,2020,대구,질병,1,0,1
Y85,2020,서울,질병,4,0,4
Y85,2021,대구,질병,0,1,1
Y85,2021,서울,질병,3,0,3
Y85,2022,대구,질병,1,1,2
Y85,2022,서울,질병,6,3,9
Y85,2023,대구,질병,0,3,3
Y85,2023,서울,질병,0,1,1
Y86,2019,대구,질병,0,6,6
Y86,2019,서울,질병,23,12,35
Y86,2020,대구,질병,2,1,3
Y86,2020,서울,질병,8,1,9
Y86,2021,서울,질병,7,0,7
Y86,2022,서울,질병,19,8,27
Y86,2023,서울,질병,4,3,7
Y87,2019,대구,질병,1,0,1
Y87,2019,서울,질병,1,0,1
Y87,2020,대구,질병,2,0,2
Y87,2020,서울,질병,1,0,1
Y87,2022,대구,질병,3,0,3
Y87,2023,서울,질병,1,0,1
Y88,2019,서울,질병,1,0,1
Y88,2020,서울,질병,1,0,1
Y88,2023,서울,질병,2,0,2
Y89,2019,서울,질병,5,2,7
Y89,2020,서울,질병,0,1,1
Y89,2022,서울,질병,0,1,1
Y89,2023,서울,질병,2,0,2
Y95,2019,서울,질병,20,24,44
Y95,2020,서울,질병,25,15,40
Y95,2021,서울,질병,23,10,33
Y95,2022,서울,질병,13,15,28
Y95,2023,서울,질병,23,11,34
Y98,2023,서울,질병,0,1,1
Z00,2019,부산,질병,0,2,2
Z00,2019,서울,질병,0,1,1
Z00,2019,인천,질병,0,1,1
Z00,2020,대전,질병,3,1,4
Z00,2020,서울,질병,0,1,1
Z00,2021,대전,질병,3,2,5
Z00,2021,부산,질병,6,1,7
Z00,2022,광주,질병,1,1,2
Z00,2022,대전,질병,1,1,2
Z00,2022,부산,질병,0,3,3
Z00,2023,광주,질병,3,8,11
Z00,2023,대전,질병,1,1,2
Z00,2023,부산,질병,30,1,31
Z00,2023,서울,질병,3,2,5
Z01,2022,광주,질병,1,0,1
Z01,2022,부산,질병,1,1,2
Z02,2019,서울,질병,14,10,24
Z02,2020,서울,질병,2,3,5
Z02,2021,서울,질병,9,8,17
Z02,2022,서울,질병,16,6,22
Z02,2023,서울,질병,8,4,12
Z03,2019,대구,질병,100,56,156
Z03,2019,서울,질병,38,52,90
Z03,2020,대구,질병,132,160,292
Z03,2020,대전,질병,2,3,5
Z03,2020,서울,질병,54,39,93
Z03,2020,인천,질병,2,0,2
Z03,2021,대구,질병,85,47,132
Z03,2021,서울,질병,37,32,69
Z03,2022,대구,질병,105,93,198
Z03,2022,서울,질병,36,21,57
Z03,2023,광주,질병,1,0,1
Z03,2023,대구,질병,181,40,221
Z03,2023,서울,질병,21,6,27
Z04,2019,서울,질병,319,1,320
Z04,2020,대전,질병,1,0,1
Z04,2020,서울,질병,153,3,156
Z04,2021,서울,질병,243,3,246
Z04,2022,서울,질병,281,0,281
Z04,2022,인천,질병,1,0,1
Z04,2023,서울,질병,325,1,326
Z08,2019,대구,질병,8,2,10
Z08,2019,대전,질병,12,5,17
Z08,2019,서울,질병,11,6,17
Z08,2020,대구,질병,6,2,8
Z08,2020,대전,질병,11,6,17
Z08,2020,서울,질병,11,3,14
Z08,2021,대구,질병,8,0,8
Z08,2021,대전,질병,13,4,17
Z08,2021,서울,질병,4,3,7
Z08,2022,대구,질병,3,0,3
Z08,2022,대전,질병,12,7,19
Z08,2022,서울,질병,2,4,6
Z08,2023,대구,질병,1,0,1
Z08,2023,대전,질병,5,0,5
Z08,2023,서울,질병,2,14,16
Z09,2019,대구,질병,1,1,2
Z09,2019,대전,질병,3,2,5
Z09,2019,서울,질병,25,12,37
Z09,2020,대전,질병,4,3,7
Z09,2020,서울,질병,28,18,46
Z09,2021,광주,질병,0,1,1
Z09,2021,대구,질병,1,0,1
Z09,2021,대전,질병,0,1,1
Z09,2021,서울,질병,12,7,19
Z09,2022,대구,질병,2,0,2
Z09,2022,대전,질병,1,1,2
Z09,2022,부산,질병,1,0,1
Z09,2022,서울,질병,10,3,13
Z09,2023,부산,질병,1,0,1
Z09,2023,서울,질병,6,3,9
Z11,2020,대구,질병,0,1,1
Z11,2020,대전,질병,12,5,17
Z11,2020,서울,질병,75,51,126
Z11,2022,대구,질병,7,21,28
Z11,2023,대구,질병,96,6,102
Z12,2019,서울,질병,0,1,1
Z12,2020,서울,질병,0,1,1
Z12,2021,대구,질병,0,1,1
Z12,2022,서울,질병,0,1,1
Z13,2023,광주,질병,1,0,1
Z20,2020,서울,질병,1,1,2
Z20,2021,부산,질병,1,0,1
Z20,2021,서울,질병,26,13,39
Z20,2022,대구,질병,28,52,80
Z20,2022,서울,질병,133,90,223
Z20,2023,대구,질병,50,3,53
Z20,2023,서울,질병,71,43,114
Z21,2019,서울,질병,1,0,1
Z21,2021,서울,질병,3,0,3
Z21,2022,서울,질병,2,0,2
Z21,2023,서울,질병,4,0,4
Z22,2019,서울,질병,1,0,1
Z22,2020,대구,질병,3,0,3
Z22,2020,서울,질병,1,0,1
Z22,2021,광주,질병,0,1,1
Z22,2021,대구,질병,0,1,1
Z22,2021,대전,질병,1,0,1
Z22,2021,서울,질병,0,3,3
Z22,2022,대구,질병,4,0,4
Z22,2022,서울,질병,0,2,2
Z22,2023,대구,질병,2,0,2
Z22,2023,서울,질병,0,1,1
Z23,2019,서울,질병,1,0,1
Z25,2020,서울,질병,0,1,1
Z26,2019,대구,질병,2,0,2
Z26,2019,부산,질병,1,0,1
Z26,2019,서울,질병,2,2,4
Z26,2021,대구,질병,2,0,2
Z29,2020,서울,질병,2,0,2
Z29,2021,서울,질병,4,2,6
Z29,2022,대구,질병,106,27,133
Z29,2022,서울,질병,71,47,118
Z29,2023,대구,질병,140,98,238
Z29,2023,서울,질병,28,19,47
Z30,2019,서울,질병,0,2,2
Z30,2020,서울,질병,0,1,1
Z30,2021,서울,질병,0,4,4
Z30,2023,서울,질병,0,1,1
Z35,2020,서울,질병,0,1,1
Z35,2021,서울,질병,0,1,1
Z36,2020,서울,질병,0,1,1
Z37,2020,서울,질병,0,2,2
Z38,2020,서울,질병,0,2,2
Z42,2021,서울,질병,0,1,1
Z43,2019,대전,질병,1,1,2
Z43,2019,서울,질병,30,12,42
Z43,2020,서울,질병,29,17,46
Z43,2021,서울,질병,23,10,33
Z43,2022,서울,질병,22,7,29
Z43,2023,서울,질병,19,9,28
Z44,2019,서울,질병,3,0,3
Z44,2020,서울,질병,7,0,7
Z44,2021,서울,질병,0,2,2
Z44,2022,서울,질병,1,1,2
Z45,2019,대구,질병,0,1,1
Z45,2019,부산,질병,6,1,7
Z45,2019,서울,질병,13,7,20
Z45,2020,대구,질병,3,0,3
Z45,2020,대전,질병,1,0,1
Z45,2020,서울,질병,12,10,22
Z45,2021,부산,질병,14,1,15
Z45,2021,서울,질병,21,9,30
Z45,2022,부산,질병,5,0,5
Z45,2022,서울,질병,20,7,27
Z45,2023,부산,질병,5,1,6
Z45,2023,서울,질병,18,12,30
Z46,2019,서울,질병,9,5,14
Z46,2020,서울,질병,14,17,31
Z46,2021,서울,질병,18,10,28
Z46,2022,서울,질병,16,9,25
Z46,2023,서울,질병,18,5,23
Z47,2019,대구,질병,31,30,61
Z47,2019,대전,질병,22,21,43
Z47,2019,부산,질병,3,0,3
Z47,2019,서울,질병,37,51,88
Z47,2019,인천,질병,1,7,8
Z47,2020,대구,질병,23,31,54
Z47,2020,대전,질병,20,16,36
Z47,2020,서울,질병,22,52,74
Z47,2020,인천,질병,1,0,1
Z47,2021,대구,질병,30,29,59
Z47,2021,대전,질병,18,15,33
Z47,2021,부산,질병,8,5,13
Z47,2021,서울,질병,30,49,79
Z47,2021,인천,질병,2,4,6
Z47,2022,광주,질병,0,1,1
Z47,2022,대구,질병,29,22,51
Z47,2022,대전,질병,15,16,31
Z47,2022,부산,질병,13,6,19
Z47,2022,서울,질병,31,54,85
Z47,2022,인천,질병,0,1,1
Z47,2023,대구,질병,38,40,78
Z47,2023,대전,질병,13,20,33
Z47,2023,부산,질병,10,4,14
Z47,2023,서울,질병,29,45,74
Z47,2023,인천,질병,1,10,11
Z48,2019,대구,질병,13,9,22
Z48,2019,서울,질병,4,2,6
Z48,2020,대구,질병,24,1,25
Z48,2020,서울,질병,6,4,10
Z48,2021,대구,질병,16,18,34
Z48,2021,대전,질병,1,0,1
Z48,2021,서울,질병,30,9,39
Z48,2022,대구,질병,19,1,20
Z48,2022,대전,질병,0,1,1
Z48,2022,서울,질병,44,12,56
Z48,2023,대구,질병,6,29,35
Z48,2023,서울,질병,53,11,64
Z49,2019,광주,질병,10,6,16
Z49,2019,서울,질병,125,71,196
Z49,2020,광주,질병,65,18,83
Z49,2020,서울,질병,86,44,130
Z49,2021,광주,질병,51,18,69
Z49,2021,서울,질병,12,6,18
Z49,2022,광주,질병,51,10,61
Z49,2022,서울,질병,9,5,14
Z49,2023,서울,질병,12,5,17
Z50,2019,대구,질병,33,10,43
Z50,2019,대전,질병,84,27,111
Z50,2019,서울,질병,418,257,675
Z50,2020,대구,질병,64,5,69
Z50,2020,대전,질병,55,16,71
Z50,2020,서울,질병,338,239,577
Z50,2020,인천,질병,1,0,1
Z50,2021,대구,질병,81,29,110
Z50,2021,대전,질병,37,12,49
Z50,2021,서울,질병,58,55,113
Z50,2022,대구,질병,156,22,178
Z50,2022,대전,질병,67,15,82
Z50,2022,서울,질병,141,84,225
Z50,2023,대구,질병,82,21,103
Z50,2023,대전,질병,28,22,50
Z50,2023,서울,질병,182,133,315
Z51,2019,대구,질병,74,112,186
Z51,2019,대전,질병,47,129,176
Z51,2019,부산,질병,16,0,16
Z51,2019,서울,질병,730,438,1168
Z51,2019,인천,질병,2,1,3
Z51,2020,대구,질병,58,131,189
Z51,2020,대전,질병,76,126,202
Z51,2020,서울,질병,663,470,1133
Z51,2020,인천,질병,1,0,1
Z51,2021,대구,질병,43,148,191
Z51,2021,대전,질병,73,164,237
Z51,2021,부산,질병,38,0,38
Z51,2021,서울,질병,506,303,809
Z51,2022,대구,질병,54,156,210
Z51,2022,대전,질병,61,167,228
Z51,2022,부산,질병,13,0,13
Z51,2022,서울,질병,351,292,643
Z51,2023,대구,질병,51,186,237
Z51,2023,대전,질병,46,183,229
Z51,2023,서울,질병,513,365,878
Z52,2019,서울,질병,0,1,1
Z52,2020,서울,질병,0,2,2
Z52,2021,서울,질병,0,3,3
Z52,2022,대전,질병,0,1,1
Z53,2019,대구,질병,14,10,24
Z53,2019,대전,질병,22,16,38
Z53,2019,서울,질병,144,95,239
Z53,2020,대구,질병,18,9,27
Z53,2020,대전,질병,20,9,29
Z53,2020,서울,질병,126,95,221
Z53,2021,대구,질병,6,8,14
Z53,2021,대전,질병,24,18,42
Z53,2021,서울,질병,124,68,192
Z53,2022,대구,질병,25,14,39
Z53,2022,대전,질병,37,25,62
Z53,2022,서울,질병,217,186,403
Z53,2023,대구,질병,13,14,27
Z53,2023,대전,질병,29,20,49
Z53,2023,서울,질병,219,136,355
Z53,2023,인천,질병,1,4,5
Z54,2019,대구,질병,18,30,48
Z54,2019,대전,질병,1,0,1
Z54,2019,서울,질병,1,2,3
Z54,2020,대구,질병,13,17,30
Z54,2020,대전,질병,1,0,1
Z54,2020,서울,질병,2,1,3
Z54,2021,대구,질병,12,1,13
Z54,2022,대구,질병,7,9,16
Z54,2022,대전,질병,3,3,6
Z54,2022,서울,질병,1,3,4
Z54,2023,대구,질병,15,2,17
Z54,2023,대전,질병,0,1,1
Z54,2023,서울,질병,1,4,5
Z58,2023,서울,질병,1,0,1
Z63,2019,대구,질병,1,0,1
Z63,2019,서울,질병,0,1,1
Z71,2019,서울,질병,0,1,1
Z71,2022,대전,질병,0,10,10
Z71,2022,서울,질병,1,0,1
Z71,2023,대전,질병,0,8,8
Z71,2023,서울,질병,1,0,1
Z73,2019,서울,질병,1,0,1
Z75,2019,대구,질병,107,43,150
Z75,2020,대구,질병,56,50,106
Z75,2021,대구,질병,55,136,191
Z75,2022,대구,질병,55,82,137
Z75,2023,대구,질병,16,0,16
Z80,2020,서울,질병,1,2,3
Z80,2022,서울,질병,1,1,2
Z80,2023,대전,질병,1,0,1
Z80,2023,서울,질병,0,1,1
Z82,2019,서울,질병,1,0,1
Z83,2023,서울,질병,1,0,1
Z85,2019,대구,질병,3,8,11
Z85,2019,대전,질병,14,0,14
Z85,2019,서울,질병,1577,479,2056
Z85,2020,대구,질병,8,0,8
Z85,2020,대전,질병,11,0,11
Z85,2020,서울,질병,1714,526,2240
Z85,2021,대구,질병,8,3,11
Z85,2021,대전,질병,5,2,7
Z85,2021,서울,질병,1945,578,2523
Z85,2021,인천,질병,0,1,1
Z85,2022,대구,질병,9,0,9
Z85,2022,대전,질병,4,4,8
Z85,2022,서울,질병,1936,566,2502
Z85,2023,대구,질병,13,6,19
Z85,2023,대전,질병,0,1,1
Z85,2023,서울,질병,2841,658,3499
Z86,2019,서울,질병,8,12,20
Z86,2020,서울,질병,15,11,26
Z86,2021,서울,질병,32,13,45
Z86,2022,서울,질병,85,62,147
Z86,2023,서울,질병,76,45,121
Z87,2019,서울,질병,1,1,2
Z87,2022,서울,질병,1,0,1
Z87,2023,부산,질병,1,0,1
Z88,2020,광주,질병,0,1,1
Z88,2023,서울,질병,2,0,2
Z89,2019,대구,질병,0,4,4
Z89,2019,서울,질병,76,23,99
Z89,2020,대구,질병,5,5,10
Z89,2020,서울,질병,57,11,68
Z89,2021,대전,질병,1,0,1
Z89,2021,서울,질병,50,13,63
Z89,2021,인천,질병,1,0,1
Z89,2022,대구,질병,1,0,1
Z89,2022,서울,질병,60,25,85
Z89,2023,대전,질병,4,0,4
Z89,2023,서울,질병,69,15,84
Z90,2019,대구,질병,11,8,19
Z90,2019,대전,질병,12,3,15
Z90,2019,서울,질병,1274,521,1795
Z90,2020,대구,질병,19,0,19
Z90,2020,대전,질병,5,1,6
Z90,2020,서울,질병,1072,555,1627
Z90,2021,대구,질병,3,1,4
Z90,2021,대전,질병,2,1,3
Z90,2021,서울,질병,865,387,1252
Z90,2022,대구,질병,12,1,13
Z90,2022,대전,질병,3,2,5
Z90,2022,서울,질병,496,191,687
Z90,2023,대구,질병,11,15,26
Z90,2023,대전,질병,2,0,2
Z90,2023,서울,질병,582,219,801
Z91,2021,서울,질병,1,0,1
Z91,2023,서울,질병,0,1,1
Z92,2019,대구,질병,1,0,1
Z92,2019,서울,질병,2,0,2
Z92,2020,대구,질병,1,0,1
Z92,2020,서울,질병,14,11,25
Z92,2021,대구,질병,2,0,2
Z92,2021,서울,질병,7,1,8
Z92,2022,서울,질병,5,0,5
Z92,2023,서울,질병,0,2,2
Z93,2019,광주,질병,0,1,1
Z93,2019,대전,질병,1,0,1
Z93,2019,서울,질병,189,79,268
Z93,2020,대구,질병,0,1,1
Z93,2020,대전,질병,2,0,2
Z93,2020,서울,질병,189,81,270
Z93,2021,광주,질병,3,0,3
Z93,2021,부산,질병,0,1,1
Z93,2021,서울,질병,201,61,262
Z93,2022,대구,질병,2,1,3
Z93,2022,대전,질병,2,0,2
Z93,2022,부산,질병,2,0,2
Z93,2022,서울,질병,72,64,136
Z93,2023,대구,질병,1,0,1
Z93,2023,서울,질병,95,62,157
Z94,2019,대구,질병,0,4,4
Z94,2019,대전,질병,2,1,3
Z94,2019,부산,질병,3,0,3
Z94,2019,서울,질병,23,14,37
Z94,2020,대구,질병,0,5,5
Z94,2020,대전,질병,1,1,2
Z94,2020,서울,질병,21,20,41
Z94,2021,대구,질병,0,3,3
Z94,2021,대전,질병,1,0,1
Z94,2021,부산,질병,3,0,3
Z94,2021,서울,질병,22,28,50
Z94,2022,대구,질병,5,0,5
Z94,2022,부산,질병,2,0,2
Z94,2022,서울,질병,14,17,31
Z94,2023,대구,질병,0,2,2
Z94,2023,대전,질병,8,0,8
Z94,2023,부산,질병,2,0,2
Z94,2023,서울,질병,19,10,29
Z95,2019,광주,질병,3,1,4
Z95,2019,대구,질병,11,9,20
Z95,2019,대전,질병,29,7,36
Z95,2019,부산,질병,20,6,26
Z95,2019,서울,질병,1491,399,1890
Z95,2020,광주,질병,6,1,7
Z95,2020,대구,질병,114,2,116
Z95,2020,대전,질병,11,1,12
Z95,2020,서울,질병,1797,406,2203
Z95,2021,광주,질병,1,0,1
Z95,2021,대구,질병,16,25,41
Z95,2021,대전,질병,36,5,41
Z95,2021,부산,질병,23,4,27
Z95,2021,서울,질병,1647,395,2042
Z95,2022,광주,질병,2,0,2
Z95,2022,대구,질병,178,4,182
Z95,2022,대전,질병,76,11,87
Z95,2022,부산,질병,27,1,28
Z95,2022,서울,질병,1292,320,1612
Z95,2023,광주,질병,9,1,10
Z95,2023,대구,질병,34,58,92
Z95,2023,대전,질병,10,4,14
Z95,2023,부산,질병,18,3,21
Z95,2023,서울,질병,1003,239,1242
Z96,2019,대구,질병,121,79,200
Z96,2019,대전,질병,23,9,32
Z96,2019,부산,질병,56,20,76
Z96,2019,서울,질병,435,490,925
Z96,2020,광주,질병,1,0,1
Z96,2020,대구,질병,99,41,140
Z96,2020,대전,질병,13,9,22
Z96,2020,서울,질병,500,483,983
Z96,2021,대구,질병,82,51,133
Z96,2021,대전,질병,56,22,78
Z96,2021,부산,질병,30,6,36
Z96,2021,서울,질병,370,376,746
Z96,2022,대구,질병,61,35,96
Z96,2022,대전,질병,41,28,69
Z96,2022,부산,질병,2,0,2
Z96,2022,서울,질병,317,443,760
Z96,2023,대구,질병,120,94,214
Z96,2023,대전,질병,2,0,2
Z96,2023,부산,질병,0,15,15
Z96,2023,서울,질병,456,532,988
Z97,2019,서울,질병,7,2,9
Z97,2020,서울,질병,12,4,16
Z97,2021,부산,질병,1,0,1
Z97,2021,서울,질병,19,2,21
Z97,2022,서울,질병,14,1,15
Z97,2023,서울,질병,16,1,17
Z98,2019,대구,질병,5,2,7
Z98,2019,대전,질병,23,16,39
Z98,2019,서울,질병,29,10,39
Z98,2020,대구,질병,3,1,4
Z98,2020,대전,질병,1,6,7
Z98,2020,서울,질병,125,44,169
Z98,2021,대구,질병,1,0,1
Z98,2021,대전,질병,3,4,7
Z98,2021,서울,질병,117,58,175
Z98,2022,대구,질병,8,0,8
Z98,2022,대전,질병,5,6,11
Z98,2022,서울,질병,183,59,242
Z98,2023,대구,질병,0,2,2
Z98,2023,대전,질병,29,29,58
Z98,2023,서울,질병,227,64,291
Z98,2023,인천,질병,1,0,1
호흡계,2020,서울,질병,0,0,0
