연도,병원,진료과,전체환자수_입원,전체환자수_외래,전체환자수_합계
2013,광주,가정의학과,14668,31469,46137
2013,광주,건강관리과,0,8160,8160
2013,광주,내과,78405,153183,231588
2013,광주,마취과,0,473,473
2013,광주,비뇨기과,3826,31809,35635
2013,광주,산부인과,17,1981,1998
2013,광주,소아청소년과,8924,30540,39464
2013,광주,신경과,7058,28599,35657
2013,광주,신경외과,10165,20197,30362
2013,광주,안과,275,21132,21407
2013,광주,외과,14486,13743,28229
2013,광주,이비인후과,170,14570,14740
2013,광주,재활의학과,25935,31145,57080
2013,광주,정신과,0,8720,8720
2013,광주,정형외과,24527,48498,73025
2013,광주,치과,0,26164,26164
2013,광주,피부과,2,27431,27433
2013,광주,핵의학과,0,265,265
2013,광주,흉부외과,2308,1834,4142
2013,대구,가정의학과,6420,9823,16243
2013,대구,건강관리과,0,10763,10763
2013,대구,내과,69085,130018,199103
2013,대구,마취과,0,2623,2623
2013,대구,비뇨기과,3485,45555,49040
2013,대구,산부인과,21,6188,6209
2013,대구,소아청소년과,585,3676,4261
2013,대구,신경과,4552,27523,32075
2013,대구,신경외과,21498,26387,47885
2013,대구,안과,384,23861,24245
2013,대구,외과,9181,12418,21599
2013,대구,응급의학과,0,0,0
2013,대구,이비인후과,174,18981,19155
2013,대구,재활의학과,24722,38062,62784
2013,대구,정신건강의학과,0,8881,8881
2013,대구,정형외과,23377,30637,54014
2013,대구,치과,0,28206,28206
2013,대구,피부과,111,24325,24436
2013,대구,핵의학과,0,4642,4642
2013,대구,흉부외과,0,0,0
2013,대전,가정의학과,14065,25323,39388
2013,대전,건강관리과,0,4765,4765
2013,대전,내과,48987,68819,117806
2013,대전,비뇨기과,943,24546,25489
2013,대전,산부인과,20,1185,1205
2013,대전,소아청소년과,26,448,474
2013,대전,신경과,10238,24530,34768
2013,대전,신경외과,6606,5349,11955
2013,대전,안과,209,13862,14071
2013,대전,외과,5896,8586,14482
2013,대전,응급실,0,5703,5703
2013,대전,이비인후과,853,11615,12468
2013,대전,재활의학과,3908,15829,19737
2013,대전,정신건강의학과,0,8475,8475
2013,대전,정신과,0,0,0
2013,대전,정형외과,28220,40484,68704
2013,대전,치과,0,21266,21266
2013,대전,통증크리닉,0,59,59
2013,대전,피부과,0,19707,19707
2013,대전,한방내과,0,7794,7794
2013,대전,한방진료과,133,0,133
2013,부산,가정의학과,8454,19897,28351
2013,부산,건강관리과,0,8025,8025
2013,부산,구분,0,0,0
2013,부산,내분비내과,8406,21655,30061
2013,부산,비뇨기과,4042,42562,46604
2013,부산,산부인과,0,2559,2559
2013,부산,소아청소년과,0,7012,7012
2013,부산,소화기내과,33175,31150,64325
2013,부산,순환기내과,7313,25473,32786
2013,부산,신경과,8927,21026,29953
2013,부산,신경외과,36578,28608,65186
2013,부산,신장내과,5863,16608,22471
2013,부산,안과,509,34946,35455
2013,부산,외과,4221,7997,12218
2013,부산,이비인후과,621,16815,17436
2013,부산,일반내과,0,30818,30818
2013,부산,재활의학과,7476,27837,35313
2013,부산,정신건강의학과,0,12351,12351
2013,부산,정형외과,40707,37688,78395
2013,부산,치과,0,26148,26148
2013,부산,피부과,0,34823,34823
2013,부산,한방진료과,0,7566,7566
2013,부산,향정신과,0,1280,1280
2013,부산,호흡기내과,8288,10136,18424
2013,중앙,가정의학과,1933,61537,63470
2013,중앙,감염내과,1041,2947,3988
2013,중앙,건강관리과,0,4401,4401
2013,중앙,기타,0,2982,2982
2013,중앙,내분비내과,4496,47128,51624
2013,중앙,류마티스내과,1107,9767,10874
2013,중앙,방사선종양학과,0,4315,4315
2013,중앙,비뇨기과,6486,81303,87789
2013,중앙,산부인과,1720,22261,23981
2013,중앙,성형외과,0,22,22
2013,중앙,소아청소년과,0,2744,2744
2013,중앙,소화기내과,16497,56484,72981
2013,중앙,순환기내과,17114,93794,110908
2013,중앙,신경과,11426,80562,91988
2013,중앙,신경외과,38838,32940,71778
2013,중앙,신장내과,14392,29601,43993
2013,중앙,안과,3156,60778,63934
2013,중앙,외과,17002,14213,31215
2013,중앙,욕창진료센터,3728,1059,4787
2013,중앙,이비인후과,6881,42313,49194
2013,중앙,일반내과,0,26600,26600
2013,중앙,재활의학과,28365,68690,97055
2013,중앙,정신건강의학과,21447,35720,57167
2013,중앙,정형외과,63496,74084,137580
2013,중앙,치과,630,108491,109121
2013,중앙,통증클리닉,828,9412,10240
2013,중앙,피부과,442,48447,48889
2013,중앙,한의과,0,7565,7565
2013,중앙,혈액종양내과,29974,18781,48755
2013,중앙,호스피스,7508,0,7508
2013,중앙,호흡기내과,14541,26118,40659
2013,중앙,흉부외과,11057,8501,19558
2014,광주,가정의학과,15682,33707,49389
2014,광주,건강관리과,0,9851,9851
2014,광주,구분,0,0,0
2014,광주,내과,71553,152566,224119
2014,광주,마취과,81,471,552
2014,광주,비뇨기과,3862,32068,35930
2014,광주,산부인과,35,1507,1542
2014,광주,소아청소년과,9790,31373,41163
2014,광주,신경과,9002,30857,39859
2014,광주,신경외과,7615,19439,27054
2014,광주,안과,172,22946,23118
2014,광주,외과,17655,13209,30864
2014,광주,이비인후과,138,15153,15291
2014,광주,재활의학과,26447,33334,59781
2014,광주,정신과,0,9070,9070
2014,광주,정형외과,24011,46964,70975
2014,광주,치과,0,29723,29723
2014,광주,피부과,0,25485,25485
2014,광주,핵의학과,0,211,211
2014,광주,흉부외과,3058,1992,5050
2014,대구,가정의학과,6350,11199,17549
2014,대구,건강관리과,0,13814,13814
2014,대구,내과,71641,130272,201913
2014,대구,마취과,0,2703,2703
2014,대구,비뇨기과,4452,45999,50451
2014,대구,산부인과,0,5698,5698
2014,대구,소아청소년과,467,2889,3356
2014,대구,신경과,3678,27501,31179
2014,대구,신경외과,23987,24689,48676
2014,대구,안과,567,23757,24324
2014,대구,외과,8019,11514,19533
2014,대구,응급의학과,0,0,0
2014,대구,이비인후과,326,19439,19765
2014,대구,재활의학과,25801,42155,67956
2014,대구,정신건강의학과,0,9403,9403
2014,대구,정형외과,21837,28862,50699
2014,대구,치과,0,28931,28931
2014,대구,피부과,50,24221,24271
2014,대구,핵의학과,0,4936,4936
2014,대구,흉부외과,0,0,0
2014,대전,가정의학과,11413,26910,38323
2014,대전,건강관리과,0,5147,5147
2014,대전,내과,29172,47483,76655
2014,대전,비뇨기과,609,25434,26043
2014,대전,산부인과,0,1272,1272
2014,대전,소아청소년과,0,343,343
2014,대전,소화기내과,9881,11577,21458
2014,대전,순환기내과,1725,0,1725
2014,대전,신경과,11445,26207,37652
2014,대전,신경외과,5738,4367,10105
2014,대전,심장내과,0,5682,5682
2014,대전,안과,187,14481,14668
2014,대전,외과,5626,8039,13665
2014,대전,응급실,0,5293,5293
2014,대전,이비인후과,433,11692,12125
2014,대전,재활의학과,3831,15246,19077
2014,대전,정신건강의학과,0,9229,9229
2014,대전,정형외과,27860,40692,68552
2014,대전,치과,0,22420,22420
2014,대전,통증크리닉,0,283,283
2014,대전,피부과,0,19177,19177
2014,대전,한방내과,0,6999,6999
2014,대전,한방진료과,125,0,125
2014,대전,호흡기내과,5713,8929,14642
2014,부산,가정의학과,8243,16496,24739
2014,부산,건강관리과,0,8327,8327
2014,부산,구분,0,0,0
2014,부산,내분비내과,8425,21889,30314
2014,부산,비뇨기과,3876,44705,48581
2014,부산,산부인과,0,2418,2418
2014,부산,소아청소년과,0,7566,7566
2014,부산,소화기내과,36413,36518,72931
2014,부산,순환기내과,7240,28759,35999
2014,부산,신경과,8265,21260,29525
2014,부산,신경외과,35190,29802,64992
2014,부산,신장내과,4069,17902,21971
2014,부산,안과,539,36656,37195
2014,부산,외과,6321,8469,14790
2014,부산,이비인후과,760,16049,16809
2014,부산,일반내과,0,35111,35111
2014,부산,재활의학과,7068,26601,33669
2014,부산,정신건강의학과,0,14127,14127
2014,부산,정형외과,41353,41400,82753
2014,부산,치과,0,27964,27964
2014,부산,피부과,0,36365,36365
2014,부산,한방진료과,0,6994,6994
2014,부산,향정신과,0,666,666
2014,부산,호흡기내과,8123,11046,19169
2014,중앙,가정의학과,1883,59854,61737
2014,중앙,감염내과,104,4353,4457
2014,중앙,건강관리과,0,5065,5065
2014,중앙,기타,0,2493,2493
2014,중앙,내분비내과,3579,48008,51587
2014,중앙,류마티스내과,1050,9490,10540
2014,중앙,방사선종양학과,0,5008,5008
2014,중앙,비뇨기과,5679,83366,89045
2014,중앙,산부인과,1743,21529,23272
2014,중앙,성형외과,488,1397,1885
2014,중앙,소아청소년과,0,3206,3206
2014,중앙,소화기내과,15459,59817,75276
2014,중앙,순환기내과,19462,96305,115767
2014,중앙,신경과,10322,82824,93146
2014,중앙,신경외과,28757,32166,60923
2014,중앙,신장내과,14180,32132,46312
2014,중앙,안과,3082,60170,63252
2014,중앙,외과,19500,15880,35380
2014,중앙,욕창진료센터,487,392,879
2014,중앙,이비인후과,6214,42591,48805
2014,중앙,일반내과,0,23777,23777
2014,중앙,재활센터신경과,599,1828,2427
2014,중앙,재활의학과,53790,86378,140168
2014,중앙,정신건강의학과,26515,36562,63077
2014,중앙,정형외과,46806,75116,121922
2014,중앙,치과,326,120228,120554
2014,중앙,통증클리닉,826,9504,10330
2014,중앙,피부과,448,48514,48962
2014,중앙,한의과,0,7936,7936
2014,중앙,혈액종양내과,30165,19599,49764
2014,중앙,호스피스,1158,0,1158
2014,중앙,호흡기내과,18092,26694,44786
2014,중앙,흉부외과,13173,9867,23040
2015,광주,가정의학과,17812,40550,58362
2015,광주,건강관리과,0,11216,11216
2015,광주,구분,0,0,0
2015,광주,내과,62182,156216,218398
2015,광주,비뇨의학과,3232,32394,35626
2015,광주,산부인과,34,2667,2701
2015,광주,소아청소년과,9442,28428,37870
2015,광주,신경과,10852,32954,43806
2015,광주,신경외과,11122,19095,30217
2015,광주,안과,293,22819,23112
2015,광주,알레르기내과,0,371,371
2015,광주,외과,19303,12477,31780
2015,광주,응급의학과,19,0,19
2015,광주,이비인후과,56,13732,13788
2015,광주,재활의학과,25607,35251,60858
2015,광주,정신건강의학과,876,857,1733
2015,광주,정형외과,25885,45398,71283
2015,광주,치과,0,29745,29745
2015,광주,피부과,0,15151,15151
2015,광주,한의과,0,0,0
2015,광주,핵의학과,0,140,140
2015,대구,가정의학과,6563,15119,21682
2015,대구,건강관리과,0,11838,11838
2015,대구,내과,70689,130209,200898
2015,대구,마취과,0,2743,2743
2015,대구,비뇨기과,4494,46264,50758
2015,대구,산부인과,0,5796,5796
2015,대구,소아청소년과,459,2364,2823
2015,대구,신경과,2970,27941,30911
2015,대구,신경외과,23158,24257,47415
2015,대구,안과,328,23104,23432
2015,대구,외과,7716,10564,18280
2015,대구,응급의학과,0,0,0
2015,대구,이비인후과,262,19180,19442
2015,대구,재활의학과,26799,46709,73508
2015,대구,정신건강의학과,0,10127,10127
2015,대구,정형외과,21284,28734,50018
2015,대구,치과,0,29249,29249
2015,대구,피부과,63,24516,24579
2015,대구,핵의학과,0,4939,4939
2015,대구,흉부외과,0,0,0
2015,대전,가정의학과,11413,26910,38323
2015,대전,건강관리과,0,5147,5147
2015,대전,내과,29172,47483,76655
2015,대전,비뇨기과,609,25434,26043
2015,대전,산부인과,0,1272,1272
2015,대전,소아청소년과,0,343,343
2015,대전,소화기내과,9881,11577,21458
2015,대전,순환기내과,1725,0,1725
2015,대전,신경과,11445,26207,37652
2015,대전,신경외과,5738,4367,10105
2015,대전,심장내과,0,5682,5682
2015,대전,안과,187,14481,14668
2015,대전,외과,5626,8039,13665
2015,대전,응급실,0,5293,5293
2015,대전,이비인후과,433,11692,12125
2015,대전,재활의학과,3831,15246,19077
2015,대전,정신건강의학과,0,9229,9229
2015,대전,정형외과,27860,40692,68552
2015,대전,치과,0,22420,22420
2015,대전,통증크리닉,0,283,283
2015,대전,피부과,0,19177,19177
2015,대전,한방내과,0,6999,6999
2015,대전,한방진료과,125,0,125
2015,대전,호흡기내과,5713,8929,14642
2015,부산,가정의학과,8672,17295,25967
2015,부산,건강관리과,0,8869,8869
2015,부산,구분,0,0,0
2015,부산,내분비내과,5718,21854,27572
2015,부산,비뇨기과,3345,44225,47570
2015,부산,산부인과,0,2368,2368
2015,부산,소아청소년과,0,6384,6384
2015,부산,소화기내과,33746,39184,72930
2015,부산,순환기내과,7407,29392,36799
2015,부산,신경과,6812,21132,27944
2015,부산,신경외과,32297,27648,59945
2015,부산,신장내과,5283,18154,23437
2015,부산,안과,406,35024,35430
2015,부산,외과,4630,7976,12606
2015,부산,이비인후과,815,15103,15918
2015,부산,일반내과,0,39005,39005
2015,부산,재활의학과,6558,24082,30640
2015,부산,정신건강의학과,0,15770,15770
2015,부산,정형외과,42420,42085,84505
2015,부산,치과,0,34258,34258
2015,부산,피부과,0,35961,35961
2015,부산,한방진료과,0,7041,7041
2015,부산,향정신과,0,553,553
2015,부산,호흡기내과,7441,10880,18321
2015,중앙,가정의학과,1953,61542,63495
2015,중앙,감염내과,1540,3979,5519
2015,중앙,건강관리과,0,4906,4906
2015,중앙,기타,0,1982,1982
2015,중앙,내분비내과,2809,48994,51803
2015,중앙,류마티스내과,564,10351,10915
2015,중앙,방사선종양학과,0,5507,5507
2015,중앙,비뇨기과,6221,83479,89700
2015,중앙,산부인과,1386,21033,22419
2015,중앙,성형외과,25,232,257
2015,중앙,소아청소년과,0,3461,3461
2015,중앙,소화기내과,15809,57903,73712
2015,중앙,순환기내과,19149,102482,121631
2015,중앙,신경과,9244,79056,88300
2015,중앙,신경외과,27274,29921,57195
2015,중앙,신장내과,14119,37040,51159
2015,중앙,안과,3513,63977,67490
2015,중앙,완화의료사업실,4788,232,5020
2015,중앙,외과,18240,16312,34552
2015,중앙,욕창진료센터,2331,196,2527
2015,중앙,응급의학과,0,0,0
2015,중앙,이비인후과,6818,43328,50146
2015,중앙,일반내과,0,14087,14087
2015,중앙,재활센터신경과,1236,4879,6115
2015,중앙,재활의학과,61190,93263,154453
2015,중앙,정신건강의학과,29230,37544,66774
2015,중앙,정형외과,43322,75043,118365
2015,중앙,치과,352,130383,130735
2015,중앙,통증클리닉,598,10152,10750
2015,중앙,피부과,556,51642,52198
2015,중앙,한의과,0,8239,8239
2015,중앙,혈액종양내과,27326,20425,47751
2015,중앙,호흡기내과,20245,27371,47616
2015,중앙,흉부외과,12545,9592,22137
2016,광주,가정의학과,18864,40035,58899
2016,광주,건강관리과,0,11534,11534
2016,광주,구분,0,0,0
2016,광주,내과,54951,159255,214206
2016,광주,비뇨의학과,4183,34508,38691
2016,광주,산부인과,10,1412,1422
2016,광주,소아청소년과,8839,30533,39372
2016,광주,신경과,7684,32375,40059
2016,광주,신경외과,14023,23481,37504
2016,광주,안과,209,22579,22788
2016,광주,알레르기내과,0,433,433
2016,광주,외과,18013,12691,30704
2016,광주,응급의학과,28,0,28
2016,광주,이비인후과,172,12433,12605
2016,광주,재활의학과,27356,34149,61505
2016,광주,정신건강의학과,0,0,0
2016,광주,정형외과,25776,44507,70283
2016,광주,치과,0,29286,29286
2016,광주,피부과,0,12569,12569
2016,광주,한의과,0,0,0
2016,광주,핵의학과,0,179,179
2016,대구,가정의학과,7563,16155,23718
2016,대구,건강관리과,0,12173,12173
2016,대구,내과,70442,130824,201266
2016,대구,마취과,0,2570,2570
2016,대구,비뇨기과,4723,47665,52388
2016,대구,산부인과,0,5843,5843
2016,대구,소아청소년과,396,2661,3057
2016,대구,신경과,2946,28552,31498
2016,대구,신경외과,21795,24853,46648
2016,대구,안과,357,23636,23993
2016,대구,외과,5881,10477,16358
2016,대구,응급의학과,0,0,0
2016,대구,이비인후과,283,18096,18379
2016,대구,재활의학과,25070,49345,74415
2016,대구,정신건강의학과,0,10732,10732
2016,대구,정형외과,23449,29524,52973
2016,대구,치과,0,29801,29801
2016,대구,피부과,111,24523,24634
2016,대구,핵의학과,0,5473,5473
2016,대구,흉부외과,0,0,0
2016,대전,가정의학과,7313,29455,36768
2016,대전,건강검진센터,0,5620,5620
2016,대전,내과,24807,38756,63563
2016,대전,마취통증의학과,0,242,242
2016,대전,비뇨기과,372,28123,28495
2016,대전,산부인과,0,1253,1253
2016,대전,소아청소년과,61,583,644
2016,대전,소화기내과,20365,20012,40377
2016,대전,신경과,13157,30338,43495
2016,대전,신경외과,9074,6278,15352
2016,대전,심장내과,5413,16951,22364
2016,대전,안과,208,14931,15139
2016,대전,외과,4328,7824,12152
2016,대전,응급의학과,0,6061,6061
2016,대전,이비인후과,550,11886,12436
2016,대전,재활의학과,6251,18726,24977
2016,대전,정신건강의학과,0,9305,9305
2016,대전,정형외과,30350,40281,70631
2016,대전,치과,0,24636,24636
2016,대전,피부과,0,20178,20178
2016,대전,한방진료과,253,6281,6534
2016,대전,호흡기내과,7287,10551,17838
2016,부산,가정의학과,9598,17248,26846
2016,부산,건강관리과,0,9899,9899
2016,부산,구분,0,0,0
2016,부산,내분비내과,5398,21621,27019
2016,부산,비뇨기과,6954,51738,58692
2016,부산,산부인과,0,2371,2371
2016,부산,소아청소년과,0,6463,6463
2016,부산,소화기내과,34662,38015,72677
2016,부산,순환기내과,7442,29829,37271
2016,부산,신경과,7413,21014,28427
2016,부산,신경외과,39076,27401,66477
2016,부산,신장내과,4360,18191,22551
2016,부산,안과,257,32913,33170
2016,부산,외과,3881,8690,12571
2016,부산,이비인후과,608,14512,15120
2016,부산,일반내과,0,43344,43344
2016,부산,재활의학과,9259,24509,33768
2016,부산,정신건강의학과,0,16890,16890
2016,부산,정형외과,43644,42248,85892
2016,부산,치과,0,38488,38488
2016,부산,피부과,0,35915,35915
2016,부산,한방진료과,0,7492,7492
2016,부산,향정신과,0,386,386
2016,부산,호흡기내과,8004,10740,18744
2016,중앙,가정의학과,1522,57113,58635
2016,중앙,감염내과,2438,10933,13371
2016,중앙,건강관리과,0,4990,4990
2016,중앙,기타,0,2041,2041
2016,중앙,내분비내과,2543,53534,56077
2016,중앙,류마티스내과,567,14198,14765
2016,중앙,방사선종양학과,0,5980,5980
2016,중앙,비뇨기과,7662,87178,94840
2016,중앙,산부인과,1438,21314,22752
2016,중앙,성형외과,0,0,0
2016,중앙,소아청소년과,4,3919,3923
2016,중앙,소화기내과,16784,61255,78039
2016,중앙,순환기내과,18363,104531,122894
2016,중앙,신경과,9083,82057,91140
2016,중앙,신경외과,27835,32399,60234
2016,중앙,신장내과,15319,36034,51353
2016,중앙,안과,3142,64671,67813
2016,중앙,완화의료사업실,9051,637,9688
2016,중앙,외과,16894,16885,33779
2016,중앙,욕창성형클리닉,2301,380,2681
2016,중앙,응급의학과,0,0,0
2016,중앙,이비인후과,7281,48110,55391
2016,중앙,일반내과,0,14600,14600
2016,중앙,재활센터신경과,1477,5235,6712
2016,중앙,재활의학과,61111,96414,157525
2016,중앙,정신건강의학과,28363,38738,67101
2016,중앙,정형외과,42998,75968,118966
2016,중앙,치과,435,142890,143325
2016,중앙,통증클리닉,520,11027,11547
2016,중앙,피부과,1000,51378,52378
2016,중앙,한의과,0,7967,7967
2016,중앙,혈액종양내과,24987,22921,47908
2016,중앙,호흡기내과,21075,34871,55946
2016,중앙,흉부외과,13810,9232,23042
2017,광주,가정의학과,17744,34094,51838
2017,광주,건강관리과,0,10697,10697
2017,광주,내과,52803,160836,213639
2017,광주,마취과,0,563,563
2017,광주,비뇨기과,4274,35831,40105
2017,광주,산부인과,36,1309,1345
2017,광주,소아청소년과,6289,29622,35911
2017,광주,신경과,7673,31298,38971
2017,광주,신경외과,14807,26345,41152
2017,광주,안과,210,23069,23279
2017,광주,외과,19275,12331,31606
2017,광주,이비인후과,467,16241,16708
2017,광주,재활의학과,27417,33968,61385
2017,광주,정신과,1,12485,12486
2017,광주,정형외과,27259,41878,69137
2017,광주,치과,0,29562,29562
2017,광주,피부과,546,23444,23990
2017,광주,핵의학과,0,198,198
2017,광주,흉부외과,0,0,0
2017,대구,가정의학과,7657,12187,19844
2017,대구,건강관리과,0,12289,12289
2017,대구,구분,0,0,0
2017,대구,내과,70516,135397,205913
2017,대구,마취과,0,2652,2652
2017,대구,비뇨의학과,4521,48736,53257
2017,대구,산부인과,0,5625,5625
2017,대구,소아청소년과,69,2194,2263
2017,대구,신경과,2201,29620,31821
2017,대구,신경외과,19627,24626,44253
2017,대구,안과,463,24214,24677
2017,대구,외과,4566,10450,15016
2017,대구,응급의학과,0,0,0
2017,대구,이비인후과,283,18788,19071
2017,대구,재활의학과,24442,49571,74013
2017,대구,정신건강의학과,0,11326,11326
2017,대구,정형외과,22285,30435,52720
2017,대구,치과,0,26466,26466
2017,대구,피부과,53,24653,24706
2017,대구,핵의학과,0,4177,4177
2017,대구,흉부외과,0,0,0
2017,대전,가정의학과,5779,28772,34551
2017,대전,건강검진센터,0,6417,6417
2017,대전,구분,0,0,0
2017,대전,내과,20968,42389,63357
2017,대전,마취통증의학과,0,0,0
2017,대전,비뇨기과,423,29514,29937
2017,대전,산부인과,0,1009,1009
2017,대전,소아청소년과,0,518,518
2017,대전,소화기내과,24609,21937,46546
2017,대전,신경과,10396,31937,42333
2017,대전,신경외과,8763,6548,15311
2017,대전,심장내과,4244,19384,23628
2017,대전,안과,183,13662,13845
2017,대전,외과,3785,7360,11145
2017,대전,응급의학과,0,5397,5397
2017,대전,이비인후과,497,11598,12095
2017,대전,재활의학과,7331,19052,26383
2017,대전,정신건강의학과,0,8776,8776
2017,대전,정형외과,33211,36996,70207
2017,대전,치과,0,23809,23809
2017,대전,피부과,0,20555,20555
2017,대전,한방진료과,114,7110,7224
2017,대전,호흡기내과,3618,5784,9402
2017,부산,가정의학과,9654,16165,25819
2017,부산,건강관리과,0,9562,9562
2017,부산,내분비내과,4690,20566,25256
2017,부산,비뇨의학과,7112,53860,60972
2017,부산,산부인과,0,2254,2254
2017,부산,소아청소년과,0,5694,5694
2017,부산,소화기내과,37532,37053,74585
2017,부산,순환기내과,6126,29403,35529
2017,부산,신경과,6033,20417,26450
2017,부산,신경외과,37618,26728,64346
2017,부산,신장내과,5213,19356,24569
2017,부산,안과,196,32746,32942
2017,부산,외과,3166,7894,11060
2017,부산,이비인후과,685,14278,14963
2017,부산,일반내과,0,44793,44793
2017,부산,재활의학과,7177,24982,32159
2017,부산,정신건강의학과,0,17613,17613
2017,부산,정형외과,40961,45127,86088
2017,부산,치과,0,34463,34463
2017,부산,피부과,0,35890,35890
2017,부산,한방진료과,0,6826,6826
2017,부산,향정신과,0,231,231
2017,부산,호흡기내과,6477,11075,17552
2017,중앙,가정의학과,1843,57393,59236
2017,중앙,감염내과,4294,15938,20232
2017,중앙,건강관리과,0,6094,6094
2017,중앙,구분,0,0,0
2017,중앙,기타,0,2550,2550
2017,중앙,내분비내과,1927,58359,60286
2017,중앙,류마티스내과,694,11044,11738
2017,중앙,방사선종양학과,0,7322,7322
2017,중앙,비뇨기과,8268,86744,95012
2017,중앙,산부인과,1164,21379,22543
2017,중앙,성형외과,0,0,0
2017,중앙,소아청소년과,0,3508,3508
2017,중앙,소화기내과,18885,63773,82658
2017,중앙,순환기내과,16138,102786,118924
2017,중앙,신경과,9099,81154,90253
2017,중앙,신경외과,25215,31402,56617
2017,중앙,신장내과,15906,38923,54829
2017,중앙,안과,3607,70240,73847
2017,중앙,완화의료사업실,9719,1142,10861
2017,중앙,외과,15512,16858,32370
2017,중앙,욕창성형클리닉,739,963,1702
2017,중앙,응급의학과,103,0,103
2017,중앙,이비인후과,6740,49420,56160
2017,중앙,일반내과,0,7384,7384
2017,중앙,재활센터신경과,1086,6080,7166
2017,중앙,재활의학과,62130,95771,157901
2017,중앙,정신건강의학과,20027,36451,56478
2017,중앙,정형외과,43119,73249,116368
2017,중앙,진료일수,0,0,0
2017,중앙,치과,285,142942,143227
2017,중앙,통증클리닉,992,11984,12976
2017,중앙,피부과,648,50623,51271
2017,중앙,한의과,0,8251,8251
2017,중앙,혈액종양내과,24496,25033,49529
2017,중앙,호흡기내과,20943,36806,57749
2017,중앙,흉부외과,15827,9380,25207
2018,광주,가정의학과,19468,30656,50124
2018,광주,건강관리과,0,11766,11766
2018,광주,내분비내과,3094,24612,27706
2018,광주,마취과,0,1020,1020
2018,광주,비뇨의학과,4241,40134,44375
2018,광주,산부인과,37,1666,1703
2018,광주,소아청소년과,6382,27425,33807
2018,광주,소화기내과,11419,35544,46963
2018,광주,순환기내과,11055,59201,70256
2018,광주,신경과,6270,31956,38226
2018,광주,신경외과,10844,25549,36393
2018,광주,신장내과,16453,15314,31767
2018,광주,안과,124,23348,23472
2018,광주,외과,15147,11948,27095
2018,광주,이비인후과,407,15337,15744
2018,광주,일반내과,0,9915,9915
2018,광주,재활의학과,28494,36253,64747
2018,광주,정신건강의학과,0,14256,14256
2018,광주,정형외과,27912,43420,71332
2018,광주,치과,0,27049,27049
2018,광주,피부과,277,26870,27147
2018,광주,한의과,0,8209,8209
2018,광주,핵의학과,0,147,147
2018,광주,혈액종양내과,3074,2364,5438
2018,광주,호흡기내과,14819,23006,37825
2018,대구,가정의학과,6622,10559,17181
2018,대구,내과,76977,139058,216035
2018,대구,마취통증의학과,0,2921,2921
2018,대구,비뇨의학과,4722,49857,54579
2018,대구,산부인과,0,5417,5417
2018,대구,소아청소년과,73,2026,2099
2018,대구,신경과,2057,28986,31043
2018,대구,신경외과,19612,24014,43626
2018,대구,안과,720,23402,24122
2018,대구,외과,2230,9153,11383
2018,대구,응급의학과,0,13314,13314
2018,대구,이비인후과,112,19303,19415
2018,대구,재활의학과,13265,49799,63064
2018,대구,정신건강의학과,0,11829,11829
2018,대구,정형외과,23718,28175,51893
2018,대구,치과,0,29070,29070
2018,대구,피부과,95,23370,23465
2018,대구,핵의학과,0,4085,4085
2018,대구,흉부외과,0,1165,1165
2018,대전,가정의학과,5281,27555,32836
2018,대전,건강검진센터,0,7713,7713
2018,대전,내과,20873,40567,61440
2018,대전,류마티스내과,216,972,1188
2018,대전,마취통증의학과,0,0,0
2018,대전,비뇨기과,640,0,640
2018,대전,비뇨의학과,0,32328,32328
2018,대전,산부인과,0,1096,1096
2018,대전,소아청소년과,49,341,390
2018,대전,소화기내과,17897,26481,44378
2018,대전,신경과,10385,34725,45110
2018,대전,신경외과,9719,7070,16789
2018,대전,신장내과,3508,4636,8144
2018,대전,심장내과,3432,22151,25583
2018,대전,안과,166,14250,14416
2018,대전,외과,4600,8203,12803
2018,대전,응급의학과,0,6064,6064
2018,대전,이비인후과,882,12762,13644
2018,대전,재활의학과,8272,20819,29091
2018,대전,정신건강의학과,0,9207,9207
2018,대전,정형외과,33662,38239,71901
2018,대전,치과,0,24072,24072
2018,대전,피부과,0,21745,21745
2018,대전,한방진료과,134,6853,6987
2018,대전,호흡기내과,6978,10228,17206
2018,부산,가정의학과,7782,17542,25324
2018,부산,건강관리과,0,10386,10386
2018,부산,내분비내과,2884,20062,22946
2018,부산,비뇨의학과,5807,56376,62183
2018,부산,산부인과,0,2276,2276
2018,부산,소아청소년과,0,5856,5856
2018,부산,소화기내과,36594,37871,74465
2018,부산,순환기내과,6311,27473,33784
2018,부산,신경과,3507,20889,24396
2018,부산,신경외과,35200,27184,62384
2018,부산,신장내과,7687,22725,30412
2018,부산,안과,180,32469,32649
2018,부산,외과,3124,8138,11262
2018,부산,이비인후과,911,14297,15208
2018,부산,일반내과,0,43945,43945
2018,부산,재활의학과,8435,27809,36244
2018,부산,정신건강의학과,0,16677,16677
2018,부산,정형외과,44088,46448,90536
2018,부산,치과,0,35123,35123
2018,부산,피부과,0,35806,35806
2018,부산,한방진료과,0,7085,7085
2018,부산,향정신과,0,242,242
2018,부산,호흡기내과,7000,11528,18528
2018,인천,가정의학과,357,2532,2889
2018,인천,내분비내과,0,0,0
2018,인천,마취통증의학과,0,65,65
2018,인천,비뇨의학과,272,4888,5160
2018,인천,소화기내과,535,3324,3859
2018,인천,순환기내과,0,0,0
2018,인천,신경과,134,2195,2329
2018,인천,신경외과,0,171,171
2018,인천,안과,0,600,600
2018,인천,외과,45,1148,1193
2018,인천,이비인후과,0,167,167
2018,인천,일반내과,118,998,1116
2018,인천,재활의학과,0,2568,2568
2018,인천,정형외과,0,638,638
2018,인천,치과,42,2359,2401
2018,인천,피부과,0,212,212
2018,인천,호흡기내과,0,0,0
2018,중앙,가정의학과,1548,54382,55930
2018,중앙,감염내과,4099,29053,33152
2018,중앙,건강관리과,0,8007,8007
2018,중앙,기타,0,2478,2478
2018,중앙,내분비내과,2216,58182,60398
2018,중앙,류마티스내과,702,11079,11781
2018,중앙,방사선종양학과,0,8088,8088
2018,중앙,비뇨기과,8048,89030,97078
2018,중앙,산부인과,1129,20749,21878
2018,중앙,성형외과,0,0,0
2018,중앙,소아청소년과,0,3355,3355
2018,중앙,소화기내과,16745,60361,77106
2018,중앙,순환기내과,18071,104291,122362
2018,중앙,신경과,8531,85006,93537
2018,중앙,신경외과,23710,29480,53190
2018,중앙,신장내과,13729,37811,51540
2018,중앙,안과,4068,72675,76743
2018,중앙,완화의료사업실,9802,1208,11010
2018,중앙,외과,15013,18017,33030
2018,중앙,욕창성형클리닉,48,1463,1511
2018,중앙,응급의학과,4057,0,4057
2018,중앙,이비인후과,5645,41823,47468
2018,중앙,일반내과,0,1,1
2018,중앙,입원전담의학과,1280,0,1280
2018,중앙,재활센터신경과,156,2596,2752
2018,중앙,재활의학과,63226,98268,161494
2018,중앙,정신건강의학과,19685,32267,51952
2018,중앙,정형외과,42881,74125,117006
2018,중앙,치과,274,139898,140172
2018,중앙,통증클리닉,1055,14340,15395
2018,중앙,피부과,255,46910,47165
2018,중앙,한의과,0,8062,8062
2018,중앙,혈액종양내과,23471,26502,49973
2018,중앙,호흡기내과,20230,35036,55266
2018,중앙,흉부외과,15561,9555,25116
2019,광주,가정의학과,17365,28829,46194
2019,광주,감염내과,997,815,1812
2019,광주,건강관리과,0,11959,11959
2019,광주,내분비내과,2222,23939,26161
2019,광주,마취과,0,1274,1274
2019,광주,비뇨의학과,4314,38769,43083
2019,광주,산부인과,24,1502,1526
2019,광주,소아청소년과,5606,27296,32902
2019,광주,소화기내과,7685,34306,41991
2019,광주,순환기내과,9669,56821,66490
2019,광주,신경과,8882,36532,45414
2019,광주,신경외과,11013,27364,38377
2019,광주,신장내과,17806,14873,32679
2019,광주,안과,142,21043,21185
2019,광주,외과,14723,10944,25667
2019,광주,응급의학과,0,0,0
2019,광주,이비인후과,154,14107,14261
2019,광주,일반내과,0,11723,11723
2019,광주,재활의학과,29837,38723,68560
2019,광주,정신건강의학과,0,13890,13890
2019,광주,정형외과,25238,37345,62583
2019,광주,치과,0,26810,26810
2019,광주,피부과,0,25414,25414
2019,광주,한의과,0,6557,6557
2019,광주,핵의학과,0,147,147
2019,광주,혈액종양내과,8385,7460,15845
2019,광주,호흡기내과,14975,23190,38165
2019,대구,가정의학과,6291,10433,16724
2019,대구,건강관리과,0,10085,10085
2019,대구,내과,80705,142072,222777
2019,대구,마취통증의학과,0,3203,3203
2019,대구,비뇨의학과,4070,50435,54505
2019,대구,산부인과,0,5270,5270
2019,대구,소아청소년과,42,1592,1634
2019,대구,신경과,1846,26301,28147
2019,대구,신경외과,26458,28395,54853
2019,대구,안과,948,23582,24530
2019,대구,외과,1729,7761,9490
2019,대구,응급의학과,0,0,0
2019,대구,이비인후과,113,19449,19562
2019,대구,재활의학과,1572,12646,14218
2019,대구,정신건강의학과,0,12065,12065
2019,대구,정형외과,23072,40260,63332
2019,대구,치과,0,29395,29395
2019,대구,피부과,139,23193,23332
2019,대구,핵의학과,0,4502,4502
2019,대구,흉부외과,0,0,0
2019,대전,가정의학과,6053,27929,33982
2019,대전,건강검진센터,0,7972,7972
2019,대전,내과,8930,24388,33318
2019,대전,류마티스내과,2683,8912,11595
2019,대전,마취통증의학과,0,0,0
2019,대전,비뇨기과,328,0,328
2019,대전,비뇨의학과,0,33039,33039
2019,대전,산부인과,0,1361,1361
2019,대전,소아청소년과,0,402,402
2019,대전,소화기내과,15113,29669,44782
2019,대전,신경과,10611,33755,44366
2019,대전,신경외과,8999,7317,16316
2019,대전,신장내과,6240,9621,15861
2019,대전,심장내과,1733,24498,26231
2019,대전,안과,163,15424,15587
2019,대전,외과,5468,9258,14726
2019,대전,응급의학과,0,0,0
2019,대전,이비인후과,1038,13319,14357
2019,대전,재활의학과,10066,24522,34588
2019,대전,정신건강의학과,0,8966,8966
2019,대전,정형외과,34761,38269,73030
2019,대전,치과,0,34255,34255
2019,대전,피부과,0,20591,20591
2019,대전,한방진료과,39,7634,7673
2019,대전,호흡기내과,9305,18024,27329
2019,부산,가정의학과,6222,19223,25445
2019,부산,건강관리과,0,10313,10313
2019,부산,내분비내과,1613,22818,24431
2019,부산,비뇨의학과,4840,58397,63237
2019,부산,산부인과,0,2329,2329
2019,부산,소아청소년과,0,6379,6379
2019,부산,소화기내과,34551,41824,76375
2019,부산,순환기내과,8407,27078,35485
2019,부산,신경과,2605,20364,22969
2019,부산,신경외과,35387,27778,63165
2019,부산,신장내과,5433,24266,29699
2019,부산,안과,157,31978,32135
2019,부산,외과,3673,8281,11954
2019,부산,이비인후과,716,14294,15010
2019,부산,일반내과,0,39848,39848
2019,부산,재활의학과,12078,32776,44854
2019,부산,정신건강의학과,0,19498,19498
2019,부산,정형외과,34795,45761,80556
2019,부산,치과,0,37610,37610
2019,부산,피부과,0,36784,36784
2019,부산,한방진료과,0,6430,6430
2019,부산,향정신과,0,243,243
2019,부산,호흡기내과,8305,16479,24784
2019,인천,가정의학과,2792,16452,19244
2019,인천,내과,30,189,219
2019,인천,마취통증의학과,0,847,847
2019,인천,비뇨의학과,3930,17666,21596
2019,인천,소화기내과,5692,16305,21997
2019,인천,순환기내과,0,2738,2738
2019,인천,신경과,1680,8375,10055
2019,인천,신경외과,651,8933,9584
2019,인천,안과,199,8059,8258
2019,인천,외과,219,1767,1986
2019,인천,이비인후과,785,7378,8163
2019,인천,재활의학과,72,2620,2692
2019,인천,정형외과,7721,15843,23564
2019,인천,진단검사의학과,0,452,452
2019,인천,치과,155,13061,13216
2019,인천,피부과,0,7422,7422
2019,중앙,가정의학과,1368,55791,57159
2019,중앙,감염내과,3957,28838,32795
2019,중앙,건강관리과,0,8873,8873
2019,중앙,기타,0,2668,2668
2019,중앙,내분비내과,983,56137,57120
2019,중앙,류마티스내과,621,11794,12415
2019,중앙,방사선종양학과,0,8608,8608
2019,중앙,비뇨의학과,7892,91322,99214
2019,중앙,산부인과,1209,19895,21104
2019,중앙,소아청소년과,0,3070,3070
2019,중앙,소화기내과,13263,63683,76946
2019,중앙,순환기내과,17113,108211,125324
2019,중앙,신경과,8592,91044,99636
2019,중앙,신경외과,20836,30311,51147
2019,중앙,신장내과,10465,39097,49562
2019,중앙,안과,5204,80460,85664
2019,중앙,완화의료사업실,9611,2261,11872
2019,중앙,외과,15107,18356,33463
2019,중앙,욕창성형클리닉,0,2157,2157
2019,중앙,응급의학과,6207,0,6207
2019,중앙,이비인후과,6056,38440,44496
2019,중앙,일반내과,0,1,1
2019,중앙,입원전담의학과,18108,0,18108
2019,중앙,재활의학과,62306,105946,168252
2019,중앙,정신건강의학과,19354,35739,55093
2019,중앙,정형외과,41513,72216,113729
2019,중앙,치과,226,138940,139166
2019,중앙,통증클리닉,676,18473,19149
2019,중앙,피부과,465,53139,53604
2019,중앙,한의과,0,7895,7895
2019,중앙,혈액종양내과,21234,26017,47251
2019,중앙,호흡기내과,12509,36885,49394
2019,중앙,흉부외과,14531,10258,24789
2020,광주,가정의학과,14202,23385,37587
2020,광주,감염내과,273,1077,1350
2020,광주,건강관리과,0,9625,9625
2020,광주,내분비내과,1133,19793,20926
2020,광주,마취과,0,942,942
2020,광주,비뇨의학과,6809,36462,43271
2020,광주,산부인과,3,1373,1376
2020,광주,소아청소년과,1135,21647,22782
2020,광주,소화기내과,6258,31692,37950
2020,광주,순환기내과,6903,51525,58428
2020,광주,신경과,11652,36414,48066
2020,광주,신경외과,12239,24337,36576
2020,광주,신장내과,17369,15007,32376
2020,광주,안과,772,22265,23037
2020,광주,외과,19915,9451,29366
2020,광주,응급의학과,4207,0,4207
2020,광주,이비인후과,9,11513,11522
2020,광주,일반내과,0,5374,5374
2020,광주,재활의학과,20983,30675,51658
2020,광주,정신건강의학과,0,13496,13496
2020,광주,정형외과,21698,31452,53150
2020,광주,치과,0,24563,24563
2020,광주,피부과,0,22178,22178
2020,광주,한의과,0,6239,6239
2020,광주,핵의학과,0,127,127
2020,광주,혈액종양내과,6371,7233,13604
2020,광주,호흡기내과,10213,20398,30611
2020,대구,가정의학과,5908,12656,18564
2020,대구,건강관리과,0,7200,7200
2020,대구,내과,63469,117127,180596
2020,대구,마취통증의학과,0,2645,2645
2020,대구,비뇨의학과,2429,46818,49247
2020,대구,산부인과,0,3803,3803
2020,대구,소아청소년과,0,1189,1189
2020,대구,순화기내과,3606,0,3606
2020,대구,순환기내과,0,6343,6343
2020,대구,신경과,1542,26659,28201
2020,대구,신경외과,20217,23604,43821
2020,대구,안과,1138,21689,22827
2020,대구,외과,3272,7089,10361
2020,대구,응급의학과,0,0,0
2020,대구,이비인후과,143,15495,15638
2020,대구,재활의학과,4381,22642,27023
2020,대구,정신건강의학과,0,11276,11276
2020,대구,정형외과,17976,26598,44574
2020,대구,치과,0,23002,23002
2020,대구,피부과,20,20431,20451
2020,대구,핵의학과,0,4470,4470
2020,대구,흉부외과,0,0,0
2020,대전,가정의학과,4075,25750,29825
2020,대전,건강검진센터,0,8274,8274
2020,대전,내과,6600,13266,19866
2020,대전,류마티스내과,1948,11355,13303
2020,대전,마취통증의학과,0,1191,1191
2020,대전,비뇨기과,232,0,232
2020,대전,비뇨의학과,0,31815,31815
2020,대전,산부인과,0,1083,1083
2020,대전,소아청소년과,109,510,619
2020,대전,소화기내과,13302,34881,48183
2020,대전,신경과,7010,31637,38647
2020,대전,신경외과,7564,6643,14207
2020,대전,신장내과,4402,12004,16406
2020,대전,심장내과,532,18760,19292
2020,대전,안과,114,13527,13641
2020,대전,외과,5272,8290,13562
2020,대전,응급의학과,0,0,0
2020,대전,이비인후과,602,12614,13216
2020,대전,재활의학과,8036,21541,29577
2020,대전,정신건강의학과,0,8795,8795
2020,대전,정형외과,33174,35855,69029
2020,대전,치과,0,30011,30011
2020,대전,피부과,0,16885,16885
2020,대전,한방진료과,0,6539,6539
2020,대전,호흡기내과,9679,17813,27492
2020,부산,가정의학과,6086,23735,29821
2020,부산,건강관리과,0,9921,9921
2020,부산,내분비내과,1151,24205,25356
2020,부산,류마티스내과,38,3199,3237
2020,부산,비뇨의학과,3923,57579,61502
2020,부산,산부인과,0,2260,2260
2020,부산,소아청소년과,0,5607,5607
2020,부산,소화기내과,31767,43716,75483
2020,부산,순환기내과,8852,31505,40357
2020,부산,신경과,2048,20008,22056
2020,부산,신경외과,32149,24993,57142
2020,부산,신장내과,4000,23818,27818
2020,부산,안과,249,33373,33622
2020,부산,외과,2379,7430,9809
2020,부산,이비인후과,405,13337,13742
2020,부산,일반내과,0,18067,18067
2020,부산,재활의학과,12152,31206,43358
2020,부산,정신건강의학과,0,19041,19041
2020,부산,정형외과,38352,42074,80426
2020,부산,치과,0,35142,35142
2020,부산,피부과,0,33678,33678
2020,부산,한방과,0,7085,7085
2020,부산,향정신과,0,248,248
2020,부산,호흡기내과,6012,17690,23702
2020,인천,가정의학과,1730,15677,17407
2020,인천,내과,4517,13359,17876
2020,인천,내분비내과,0,0,0
2020,인천,마취통증의학과,0,668,668
2020,인천,비뇨의학과,6472,20656,27128
2020,인천,소화기내과,3090,10344,13434
2020,인천,순환기내과,0,748,748
2020,인천,신경과,202,1342,1544
2020,인천,신경외과,2405,13372,15777
2020,인천,안과,331,8069,8400
2020,인천,외과,546,1201,1747
2020,인천,이비인후과,1254,7447,8701
2020,인천,재활의학과,157,755,912
2020,인천,정형외과,6960,12974,19934
2020,인천,진단검사의학과,0,183,183
2020,인천,치과,172,14317,14489
2020,인천,피부과,0,7846,7846
2020,인천,호흡기내과,0,0,0
2020,중앙,가정의학과,268,62279,62547
2020,중앙,감염내과,1391,9285,10676
2020,중앙,감염병전담의학과,853,0,853
2020,중앙,건강관리과,0,6817,6817
2020,중앙,기타,0,2522,2522
2020,중앙,내분비내과,1482,56988,58470
2020,중앙,류마티스내과,557,13131,13688
2020,중앙,방사선종양학과,0,9269,9269
2020,중앙,비뇨의학과,8001,88922,96923
2020,중앙,산부인과,1138,17998,19136
2020,중앙,성형외과,113,946,1059
2020,중앙,소아청소년과,0,2482,2482
2020,중앙,소화기내과,12105,60959,73064
2020,중앙,순환기내과,14983,101047,116030
2020,중앙,신경과,7093,85181,92274
2020,중앙,신경외과,16316,29047,45363
2020,중앙,신생아과,0,0,0
2020,중앙,신장내과,9773,35718,45491
2020,중앙,안과,4575,75380,79955
2020,중앙,완화의료사업실,9483,1713,11196
2020,중앙,외과,14732,16223,30955
2020,중앙,욕창성형클리닉,0,1713,1713
2020,중앙,응급의학과,4929,0,4929
2020,중앙,이비인후과,5178,34439,39617
2020,중앙,일반내과,0,2,2
2020,중앙,입원전담의학과,14888,0,14888
2020,중앙,재활의학과,49713,91824,141537
2020,중앙,정신건강의학과,16333,34473,50806
2020,중앙,정형외과,36504,66984,103488
2020,중앙,치과,158,125613,125771
2020,중앙,통증클리닉,149,15859,16008
2020,중앙,피부과,231,50645,50876
2020,중앙,한의과,0,7875,7875
2020,중앙,혈액종양내과,18075,24331,42406
2020,중앙,호흡기내과,11979,35798,47777
2020,중앙,흉부외과,9666,10391,20057
2021,광주,가정의학과,11483,22422,33905
2021,광주,감염내과,3505,5275,8780
2021,광주,건강관리과,0,7667,7667
2021,광주,내분비내과,849,17665,18514
2021,광주,마취과,0,793,793
2021,광주,비뇨의학과,7349,36948,44297
2021,광주,산부인과,11,6883,6894
2021,광주,소아청소년과,20,22943,22963
2021,광주,소화기내과,4945,29441,34386
2021,광주,순환기내과,6922,51115,58037
2021,광주,신경과,10271,38928,49199
2021,광주,신경외과,12582,25457,38039
2021,광주,신장내과,13825,15521,29346
2021,광주,안과,564,21016,21580
2021,광주,외과,20355,9343,29698
2021,광주,응급의학과,5040,206,5246
2021,광주,이비인후과,33,11501,11534
2021,광주,일반내과,0,9023,9023
2021,광주,재활의학과,23036,32962,55998
2021,광주,정신건강의학과,0,13927,13927
2021,광주,정형외과,24063,35370,59433
2021,광주,치과,0,25185,25185
2021,광주,피부과,0,20985,20985
2021,광주,한의과,0,6005,6005
2021,광주,핵의학과,0,162,162
2021,광주,혈액종양내과,5140,7439,12579
2021,광주,호흡기내과,11250,18553,29803
2021,대구,가정의학과,5812,12380,18192
2021,대구,감염내과,0,9953,9953
2021,대구,건강관리과,0,8453,8453
2021,대구,내과,14036,26168,40204
2021,대구,내분비내과,4589,17198,21787
2021,대구,마취통증의학과,0,3038,3038
2021,대구,비뇨의학과,2584,44497,47081
2021,대구,산부인과,0,4533,4533
2021,대구,소아청소년과,0,888,888
2021,대구,소화기내과,19487,34485,53972
2021,대구,순환기내과,24412,39805,64217
2021,대구,신경과,2231,31684,33915
2021,대구,신경외과,25005,24894,49899
2021,대구,신장내과,7443,19488,26931
2021,대구,안과,1288,23092,24380
2021,대구,외과,2892,8692,11584
2021,대구,응급의학과,0,0,0
2021,대구,이비인후과,57,17308,17365
2021,대구,재활의학과,11290,35472,46762
2021,대구,정신건강의학과,0,11906,11906
2021,대구,정형외과,22894,28311,51205
2021,대구,치과,0,26040,26040
2021,대구,피부과,28,21633,21661
2021,대구,핵의학과,0,4909,4909
2021,대구,호흡기내과,0,0,0
2021,대구,흉부외과,0,0,0
2021,대전,가정의학과,3854,32429,36283
2021,대전,건강검진센터,0,8856,8856
2021,대전,내과,1609,5228,6837
2021,대전,내분비내과,695,5500,6195
2021,대전,류마티스내과,2319,10796,13115
2021,대전,마취통증의학과,0,2987,2987
2021,대전,비뇨기과,180,0,180
2021,대전,비뇨의학과,0,31646,31646
2021,대전,산부인과,0,13289,13289
2021,대전,소아청소년과,1496,2753,4249
2021,대전,소화기내과,13258,39456,52714
2021,대전,신경과,6118,32258,38376
2021,대전,신경외과,6882,6521,13403
2021,대전,신장내과,1868,10262,12130
2021,대전,심장내과,459,16202,16661
2021,대전,안과,207,13453,13660
2021,대전,외과,5344,8630,13974
2021,대전,응급의학과,0,0,0
2021,대전,이비인후과,250,11303,11553
2021,대전,재활의학과,5163,21701,26864
2021,대전,정신건강의학과,0,8384,8384
2021,대전,정형외과,30899,36572,67471
2021,대전,치과,0,27205,27205
2021,대전,피부과,0,16231,16231
2021,대전,한방진료과,0,6057,6057
2021,대전,혈액종양내과,9240,10550,19790
2021,대전,호흡기내과,13824,15917,29741
2021,부산,가정의학과,6259,20711,26970
2021,부산,건강관리과,0,8265,8265
2021,부산,내분비내과,305,23334,23639
2021,부산,류마티스내과,170,4403,4573
2021,부산,비뇨의학과,3262,56417,59679
2021,부산,산부인과,0,4639,4639
2021,부산,소아청소년과,60,28920,28980
2021,부산,소화기내과,31032,43448,74480
2021,부산,순환기내과,8537,30759,39296
2021,부산,신경과,1290,20633,21923
2021,부산,신경외과,32569,25107,57676
2021,부산,신장내과,2875,22595,25470
2021,부산,안과,140,34558,34698
2021,부산,외과,2953,7554,10507
2021,부산,이비인후과,386,13104,13490
2021,부산,일반내과,34,23295,23329
2021,부산,재활의학과,9241,29529,38770
2021,부산,정신건강의학과,0,16094,16094
2021,부산,정형외과,33351,40835,74186
2021,부산,치과,0,34675,34675
2021,부산,피부과,0,31898,31898
2021,부산,한방과,0,7227,7227
2021,부산,향정신과,0,245,245
2021,부산,혈액종양내과,1091,1705,2796
2021,부산,호흡기내과,7370,16231,23601
2021,인천,가정의학과,1160,16377,17537
2021,인천,내과,6022,16287,22309
2021,인천,내분비내과,0,0,0
2021,인천,마취통증의학과,0,913,913
2021,인천,비뇨의학과,6436,23134,29570
2021,인천,소화기내과,4110,11245,15355
2021,인천,순환기내과,0,2168,2168
2021,인천,신경과,100,3901,4001
2021,인천,신경외과,2983,5614,8597
2021,인천,안과,450,9115,9565
2021,인천,외과,1076,3433,4509
2021,인천,이비인후과,263,7419,7682
2021,인천,재활의학과,1617,8246,9863
2021,인천,정형외과,8286,9533,17819
2021,인천,진단검사의학과,0,142,142
2021,인천,치과,186,14443,14629
2021,인천,피부과,0,7715,7715
2021,인천,호흡기내과,0,0,0
2021,중앙,가정의학과,235,65917,66152
2021,중앙,감염내과,114,14636,14750
2021,중앙,감염병전담의학과,24937,0,24937
2021,중앙,건강관리과,0,8423,8423
2021,중앙,기타,0,1711,1711
2021,중앙,내분비내과,1186,50809,51995
2021,중앙,류마티스내과,197,12803,13000
2021,중앙,방사선종양학과,0,8686,8686
2021,중앙,비뇨의학과,8555,91342,99897
2021,중앙,산부인과,941,18614,19555
2021,중앙,성형외과,102,5131,5233
2021,중앙,소아청소년과,0,3438,3438
2021,중앙,소화기내과,8151,54285,62436
2021,중앙,순환기내과,12705,95202,107907
2021,중앙,신경과,4690,84797,89487
2021,중앙,신경외과,14681,28033,42714
2021,중앙,신생아과,0,0,0
2021,중앙,신장내과,8728,32137,40865
2021,중앙,안과,4631,75818,80449
2021,중앙,완화의료사업실,9224,1599,10823
2021,중앙,외과,12945,17645,30590
2021,중앙,욕창성형클리닉,0,0,0
2021,중앙,응급의학과,0,0,0
2021,중앙,이비인후과,5739,36288,42027
2021,중앙,일반내과,0,6,6
2021,중앙,입원전담의학과,6696,0,6696
2021,중앙,재활의학과,18665,91471,110136
2021,중앙,정신건강의학과,13305,35774,49079
2021,중앙,정형외과,35725,70373,106098
2021,중앙,치과,172,133292,133464
2021,중앙,통증클리닉,48,14904,14952
2021,중앙,피부과,128,50485,50613
2021,중앙,한의과,0,7881,7881
2021,중앙,혈액종양내과,16237,22710,38947
2021,중앙,호흡기내과,7973,29817,37790
2021,중앙,흉부외과,8762,10881,19643
2022,광주,가정의학과,7995,20127,28122
2022,광주,감염내과,2051,2699,4750
2022,광주,건강관리과,0,7161,7161
2022,광주,내분비내과,479,15972,16451
2022,광주,마취과,0,748,748
2022,광주,비뇨의학과,7447,36060,43507
2022,광주,산부인과,0,4357,4357
2022,광주,소아청소년과,145,23697,23842
2022,광주,소화기내과,3703,22544,26247
2022,광주,순환기내과,4509,43730,48239
2022,광주,신경과,10983,38722,49705
2022,광주,신경외과,862,11696,12558
2022,광주,신장내과,5284,14940,20224
2022,광주,안과,50,12143,12193
2022,광주,외과,21293,9446,30739
2022,광주,응급의학과,4126,23,4149
2022,광주,이비인후과,28,10885,10913
2022,광주,일반내과,0,10870,10870
2022,광주,재활의학과,29738,36698,66436
2022,광주,정신건강의학과,0,12887,12887
2022,광주,정형외과,13069,30906,43975
2022,광주,치과,0,21723,21723
2022,광주,피부과,0,15516,15516
2022,광주,한의과,0,5160,5160
2022,광주,핵의학과,0,193,193
2022,광주,혈액종양내과,3340,6420,9760
2022,광주,호흡기내과,4094,11175,15269
2022,대구,가정의학과,5135,7700,12835
2022,대구,감염내과,0,16062,16062
2022,대구,건강관리과,0,7621,7621
2022,대구,내과,0,8729,8729
2022,대구,내분비내과,6059,16709,22768
2022,대구,마취통증의학과,0,2641,2641
2022,대구,비뇨의학과,1587,41432,43019
2022,대구,산부인과,0,6472,6472
2022,대구,소아청소년과,0,1204,1204
2022,대구,소화기내과,25733,42949,68682
2022,대구,순환기내과,22068,42290,64358
2022,대구,신경과,1290,30958,32248
2022,대구,신경외과,21183,24187,45370
2022,대구,신장내과,9939,21602,31541
2022,대구,안과,1072,23210,24282
2022,대구,외과,2026,9186,11212
2022,대구,응급의학과,0,0,0
2022,대구,이비인후과,0,17740,17740
2022,대구,재활의학과,15591,37586,53177
2022,대구,정신건강의학과,0,11799,11799
2022,대구,정형외과,17640,25564,43204
2022,대구,치과,0,25953,25953
2022,대구,피부과,0,20109,20109
2022,대구,핵의학과,0,4946,4946
2022,대구,호흡기내과,0,0,0
2022,대구,흉부외과,0,0,0
2022,대전,가정의학과,2413,31802,34215
2022,대전,건강검진센터,0,8311,8311
2022,대전,내과,1312,5946,7258
2022,대전,내분비내과,836,8628,9464
2022,대전,류마티스내과,1528,6931,8459
2022,대전,마취통증의학과,0,3458,3458
2022,대전,비뇨기과,179,0,179
2022,대전,비뇨의학과,0,33099,33099
2022,대전,산부인과,0,10919,10919
2022,대전,소아청소년과,373,324,697
2022,대전,소화기내과,8885,36274,45159
2022,대전,신경과,4640,31681,36321
2022,대전,신경외과,4632,5788,10420
2022,대전,신장내과,2771,12012,14783
2022,대전,심장내과,982,20517,21499
2022,대전,안과,259,12404,12663
2022,대전,영상의학과,0,9,9
2022,대전,외과,4615,8334,12949
2022,대전,응급의학과,0,0,0
2022,대전,이비인후과,138,11152,11290
2022,대전,재활의학과,4041,19246,23287
2022,대전,정신건강의학과,0,6181,6181
2022,대전,정형외과,28655,39984,68639
2022,대전,치과,0,26314,26314
2022,대전,피부과,0,12799,12799
2022,대전,한방진료과,0,5851,5851
2022,대전,혈액종양내과,8190,9479,17669
2022,대전,호흡기내과,7420,13184,20604
2022,부산,가정의학과,5763,29495,35258
2022,부산,건강관리과,0,7617,7617
2022,부산,내분비내과,53,22840,22893
2022,부산,류마티스내과,19,4570,4589
2022,부산,비뇨의학과,3224,54427,57651
2022,부산,산부인과,0,2253,2253
2022,부산,소아청소년과,0,29012,29012
2022,부산,소화기내과,23978,41929,65907
2022,부산,순환기내과,7773,34245,42018
2022,부산,신경과,1314,19324,20638
2022,부산,신경외과,29423,24805,54228
2022,부산,신장내과,1573,20932,22505
2022,부산,안과,0,27797,27797
2022,부산,외과,1135,6545,7680
2022,부산,이비인후과,355,12862,13217
2022,부산,일반내과,0,16374,16374
2022,부산,재활의학과,12423,32106,44529
2022,부산,정신건강의학과,0,18194,18194
2022,부산,정형외과,30830,38840,69670
2022,부산,치과,0,33954,33954
2022,부산,피부과,0,28762,28762
2022,부산,한방과,0,6353,6353
2022,부산,향정신과,0,233,233
2022,부산,혈액종양내과,1262,2433,3695
2022,부산,호흡기내과,7892,14672,22564
2022,인천,가정의학과,411,18967,19378
2022,인천,내과,2488,16711,19199
2022,인천,내분비내과,0,0,0
2022,인천,마취통증의학과,0,2239,2239
2022,인천,비뇨의학과,4937,26650,31587
2022,인천,소화기내과,428,8006,8434
2022,인천,순환기내과,0,418,418
2022,인천,신경과,28,5127,5155
2022,인천,신경외과,1707,5777,7484
2022,인천,안과,0,5754,5754
2022,인천,외과,570,6715,7285
2022,인천,이비인후과,29,7894,7923
2022,인천,재활의학과,1878,13582,15460
2022,인천,정형외과,1263,11258,12521
2022,인천,진단검사의학과,0,362,362
2022,인천,치과,0,13574,13574
2022,인천,피부과,0,7773,7773
2022,인천,호흡기내과,0,0,0
2022,중앙,가정의학과,367,57744,58111
2022,중앙,감염내과,1166,19550,20716
2022,중앙,감염병전담의학과,5655,0,5655
2022,중앙,건강관리과,0,7301,7301
2022,중앙,기타,0,1741,1741
2022,중앙,내분비내과,1252,53347,54599
2022,중앙,류마티스내과,245,13152,13397
2022,중앙,방사선종양학과,0,7105,7105
2022,중앙,비뇨의학과,10002,84347,94349
2022,중앙,산부인과,782,16987,17769
2022,중앙,성형외과,0,6767,6767
2022,중앙,소아청소년과,0,2090,2090
2022,중앙,소화기내과,8732,48033,56765
2022,중앙,순환기내과,13350,96951,110301
2022,중앙,신경과,5009,80683,85692
2022,중앙,신경외과,13854,27665,41519
2022,중앙,신장내과,8572,31907,40479
2022,중앙,안과,3674,72391,76065
2022,중앙,완화의료사업실,0,1750,1750
2022,중앙,외과,12732,15787,28519
2022,중앙,욕창성형클리닉,0,0,0
2022,중앙,응급의학과,0,0,0
2022,중앙,이비인후과,5125,35267,40392
2022,중앙,일반내과,0,2,2
2022,중앙,입원전담의학과,3500,0,3500
2022,중앙,재활의학과,29375,84356,113731
2022,중앙,정신건강의학과,13278,32415,45693
2022,중앙,정형외과,30779,68222,99001
2022,중앙,치과,142,128290,128432
2022,중앙,통증클리닉,50,12615,12665
2022,중앙,피부과,66,38847,38913
2022,중앙,한의과,0,7687,7687
2022,중앙,혈액종양내과,11969,20725,32694
2022,중앙,호스피스완화의료센터,8913,0,8913
2022,중앙,호흡기·알레르기내과,11115,32432,43547
2022,중앙,흉부외과,8959,10315,19274
2023,광주,가정의학과,9800,19311,29111
2023,광주,감염내과,1107,2098,3205
2023,광주,건강관리과,0,7077,7077
2023,광주,내분비내과,1892,15166,17058
2023,광주,마취과,0,726,726
2023,광주,비뇨의학과,10358,37182,47540
2023,광주,산부인과,0,3880,3880
2023,광주,소아청소년과,209,23493,23702
2023,광주,소화기내과,8219,26662,34881
2023,광주,순환기내과,14022,47452,61474
2023,광주,신경과,10670,39239,49909
2023,광주,신경외과,6217,7849,14066
2023,광주,신장내과,4547,15833,20380
2023,광주,안과,720,18748,19468
2023,광주,영상의학과,0,331,331
2023,광주,외과,23637,8456,32093
2023,광주,응급의학과,1283,14808,16091
2023,광주,이비인후과,1338,14348,15686
2023,광주,일반내과,0,10781,10781
2023,광주,재활의학과,37283,39583,76866
2023,광주,정신건강의학과,0,12050,12050
2023,광주,정형외과,10176,27225,37401
2023,광주,치과,0,21737,21737
2023,광주,피부과,0,16289,16289
2023,광주,한의과,0,6094,6094
2023,광주,핵의학과,0,228,228
2023,광주,혈액종양내과,2834,5559,8393
2023,광주,호흡기내과,380,2191,2571
2023,대구,가정의학과,5555,43168,48723
2023,대구,감염내과,0,26347,26347
2023,대구,건강관리과,0,25885,25885
2023,대구,내과,0,0,0
2023,대구,내분비내과,3966,35314,39280
2023,대구,마취통증의학과,0,24670,24670
2023,대구,비뇨의학과,2660,19713,22373
2023,대구,산부인과,0,2736,2736
2023,대구,소아청소년과,0,5099,5099
2023,대구,소화기내과,20828,0,20828
2023,대구,순환기내과,26813,10578,37391
2023,대구,신경과,521,1958,2479
2023,대구,신경외과,21234,24870,46104
2023,대구,신장내과,8946,0,8946
2023,대구,안과,663,1431,2094
2023,대구,외과,1518,11994,13512
2023,대구,응급의학과,0,0,0
2023,대구,이비인후과,0,23670,23670
2023,대구,재활의학과,19771,40879,60650
2023,대구,정신건강의학과,0,28090,28090
2023,대구,정형외과,21393,0,21393
2023,대구,치과,0,10563,10563
2023,대구,피부과,0,18453,18453
2023,대구,핵의학과,0,7353,7353
2023,대구,핵의학과,0,4790,4790
2023,대구,호흡기내과,0,43820,43820
2023,대구,흉부외과,0,9722,9722
2023,대전,가정간호사업실,0,0,0
2023,대전,가정의학과,2368,35219,37587
2023,대전,건강검진센터,0,8086,8086
2023,대전,건강검진실,0,0,0
2023,대전,내과,1204,6960,8164
2023,대전,내분비내과,683,9150,9833
2023,대전,류마티스내과,422,4701,5123
2023,대전,마취통증의학과,0,3519,3519
2023,대전,비뇨의학과,205,33413,33618
2023,대전,산부인과,0,1907,1907
2023,대전,소아청소년과,0,150,150
2023,대전,소화기내과,7481,38090,45571
2023,대전,신경과,4097,32424,36521
2023,대전,신경외과,4973,5661,10634
2023,대전,신장내과,3005,13411,16416
2023,대전,심장내과,767,17999,18766
2023,대전,심장초음파실,0,0,0
2023,대전,안과,249,11721,11970
2023,대전,암센터,0,0,0
2023,대전,영상의학과,0,0,0
2023,대전,외과,6496,8795,15291
2023,대전,응급실,0,0,0
2023,대전,응급의학과,0,4760,4760
2023,대전,이비인후과,518,12637,13155
2023,대전,재활의학과,9027,23074,32101
2023,대전,정신건강의학과,0,7885,7885
2023,대전,정형외과,34817,39621,74438
2023,대전,진단검사의학과,0,0,0
2023,대전,치과,0,24153,24153
2023,대전,통증클리닉,0,0,0
2023,대전,피부과,0,12291,12291
2023,대전,한방진료과,0,6496,6496
2023,대전,핵의학과,0,0,0
2023,대전,혈액종양내과,9223,9340,18563
2023,대전,호스피스실,0,0,0
2023,대전,호흡기내과,5558,15532,21090
2023,부산,가정의학과,17,23514,23531
2023,부산,건강관리과,0,6585,6585
2023,부산,내분비내과,22,15804,15826
2023,부산,류마티스내과,20,4939,4959
2023,부산,마취통증의학과,0,0,0
2023,부산,비뇨의학과,4143,54045,58188
2023,부산,산부인과,0,2357,2357
2023,부산,소아청소년과,0,11366,11366
2023,부산,소화기내과,24540,40001,64541
2023,부산,순환기내과,10708,37541,48249
2023,부산,신경과,1144,18092,19236
2023,부산,신경외과,34074,24220,58294
2023,부산,신장내과,2323,20271,22594
2023,부산,안과,119,30584,30703
2023,부산,외과,3,6595,6598
2023,부산,이비인후과,344,13029,13373
2023,부산,일반내과,0,13379,13379
2023,부산,재활의학과,50,38735,38785
2023,부산,정신건강의학과,0,18507,18507
2023,부산,정형외과,30568,36326,66894
2023,부산,치과,0,33818,33818
2023,부산,피부과,0,29657,29657
2023,부산,한방과,0,5632,5632
2023,부산,향정신과,0,141,141
2023,부산,혈액종양내과,1568,2685,4253
2023,부산,호흡기·알레르기내과,6412,15816,22228
2023,인천,가정의학과,989,17802,18791
2023,인천,내과,2618,16135,18753
2023,인천,마취통증의학과,0,1343,1343
2023,인천,비뇨의학과,7884,23216,31100
2023,인천,신경과,1157,6754,7911
2023,인천,신경외과,831,2882,3713
2023,인천,안과,204,7621,7825
2023,인천,영상의학과,0,108,108
2023,인천,외과,317,3106,3423
2023,인천,응급의학과,0,564,564
2023,인천,이비인후과,240,9389,9629
2023,인천,재활의학과,4047,17721,21768
2023,인천,정형외과,9906,15551,25457
2023,인천,치과,0,10415,10415
2023,인천,피부과,0,9042,9042
2023,인천,호흡기내과,1018,5765,6783
2023,중앙,가정의학과,1186,54756,55942
2023,중앙,감염내과,4266,15579,19845
2023,중앙,건강관리과,0,6688,6688
2023,중앙,기타,0,1951,1951
2023,중앙,내분비내과,1906,54513,56419
2023,중앙,류마티스내과,269,13136,13405
2023,중앙,방사선종양학과,0,7860,7860
2023,중앙,비뇨의학과,12978,87737,100715
2023,중앙,산부인과,1038,16984,18022
2023,중앙,성형외과,0,3547,3547
2023,중앙,소아청소년과,0,1416,1416
2023,중앙,소화기내과,10977,42727,53704
2023,중앙,순환기내과,14729,98161,112890
2023,중앙,신경과,7106,81432,88538
2023,중앙,신경외과,16249,27955,44204
2023,중앙,신장내과,8993,34190,43183
2023,중앙,안과,4919,71070,75989
2023,중앙,외과,14483,15345,29828
2023,중앙,이비인후과,5693,34504,40197
2023,중앙,일반내과,0,0,0
2023,중앙,입원전담의학과,6409,0,6409
2023,중앙,재활의학과,50844,85376,136220
2023,중앙,정신건강의학과,13109,30386,43495
2023,중앙,정형외과,36217,67021,103238
2023,중앙,치과,142,141752,141894
2023,중앙,통증클리닉,142,13072,13214
2023,중앙,피부과,80,34641,34721
2023,중앙,한의과,0,8437,8437
2023,중앙,혈액종양내과,13970,21916,35886
2023,중앙,호스피스완화의료센터,9612,1689,11301
2023,중앙,호흡기내과,14045,38869,52914
2023,중앙,흉부외과,9959,10271,20230
